珠光宝气	zhu guang bao qi
心急如焚	xin ji ru fen
乘人之危	cheng ren zhi wei
文武全才	wen wu quan cai
独木难支	du mu nan zhi
一文不名	yi wen bu ming
羊入虎口	yang ru hu kou
劳逸结合	lao yi jie he
不得要领	bu de yao ling
悬崖勒马	xuan ya le ma
披头散发	pi tou san fa
明知故问	ming zhi gu wen
相亲相爱	xiang qin xiang ai
异口同声	yi kou tong sheng
蛊惑人心	gu huo ren xin
忘乎所以	wang hu suo yi
前仆后继	qian pu hou ji
在所不惜	zai suo bu xi
百读不厌	bai du bu yan
指名道姓	zhi ming dao xing
稳若泰山	wen ruo tai shan
天涯海角	tian ya hai jiao
等闲视之	deng xian shi zhi
眉开眼笑	mei kai yan xiao
满腔热忱	man qiang re chen
星火燎原	xing huo liao yuan
纵虎归山	zong hu gui shan
身强力壮	shen qiang li zhuang
前仰后合	qian yang hou he
与人为善	yu ren wei shan
一落千丈	yi luo qian zhang
因地制宜	yin di zhi yi
三番两次	san fan liang ci
有福同享	you fu tong xiang
狭路相逢	xia lu xiang feng
动人心弦	dong ren xin xian
虚情假意	xu qing jia yi
至死不变	zhi si bu bian
才德兼备	cai de jian bei
舍身取义	she shen qu yi
痴心妄想	chi xin wang xiang
无独有偶	wu du you ou
信以为真	xin yi wei zhen
手慌脚乱	shou huang jiao luan
暴风骤雨	bao feng zhou yu
以偏概全	yi pian gai quan
不亦乐乎	bu yi le hu
特立独行	te li du xing
老气横秋	lao qi heng qiu
根深柢固	gen shen di gu
望文生义	wang wen sheng yi
无言以对	wu yan yi dui
体无完肤	ti wu wan fu
天渊之别	tian yuan zhi bie
亡羊补牢	wang yang bu lao
轻言细语	qing yan xi yu
浑身是胆	hun shen shi dan
化为乌有	hua wei wu you
用武之地	yong wu zhi di
无恶不作	wu e bu zuo
引以为荣	yin yi wei rong
忠言逆耳	zhong yan ni er
独往独来	du wang du lai
百无一失	bai wu yi shi
寻根究底	xun gen jiu di
龙潭虎穴	long tan hu xue
人人自危	ren ren zi wei
万马奔腾	wan ma ben teng
受益匪浅	shou yi fei qian
三长两短	san chang liang duan
欣欣向荣	xin xin xiang rong
树大招风	shu da zhao feng
有目共睹	you mu gong du
心血来潮	xin xue lai chao
鸿篇巨制	hong pian ju zhi
树大根深	shu da gen shen
千丝万缕	qian si wan lu
庞然大物	pang ran da wu
朽木难雕	xiu mu nan diao
出乎预料	chu hu yu liao
风轻云淡	feng qing yun dan
歪风邪气	wai feng xie qi
空中楼阁	kong zhong lou ge
井然有序	jing ran you xu
言归正传	yan gui zheng zhuan
喜从天降	xi cong tian jiang
不翼而飞	bu yi er fei
不懂装懂	bu dong zhuang dong
左思右想	zuo si you xiang
同出一辙	tong chu yi zhe
心惊肉跳	xin jing rou tiao
厚颜无耻	hou yan wu chi
独具匠心	du ju jiang xin
勤学苦练	qin xue ku zh
心惊胆战	xin jing dan zhan
黯然失色	an ran shi se
翻箱倒柜	fan xiang dao gui
据理力争	ju li li zheng
放任自流	fang ren zi liu
惶恐不安	huang kong bu an
心悦诚服	xin yue cheng fu
前功尽弃	qian gong jin qi
不留余地	bu liu yu di
不由自主	bu you zi zhu
正大光明	zheng da guang ming
敷衍了事	fu yan liao shi
行之有效	xing zhi you xiao
刚正不阿	gang zheng bu e
口不择言	kou bu ze yan
软硬兼施	ruan ying jian shi
和风细雨	he feng xi yu
触手可及	chu shou ke ji
心无二用	xin wu er yong
生不逢时	sheng bu feng shi
慷慨解囊	kang kai jie nang
证据确凿	zheng ju que zao
哀声叹气	ai sheng tan qi
鼎鼎有名	ding ding you ming
面面相觑	mian mian xiang qu
话里有话	hua li you hua
满不在乎	man bu zai hu
一相情愿	yi xiang qing yuan
相提并论	xiang ti bing lun
人仰马翻	ren yang ma fan
掌上明珠	zhang shang ming zhu
幸灾乐祸	xing zai le huo
峥嵘岁月	zheng rong sui yue
天之骄子	tian zhi jiao zi
祸从天降	huo cong tian jiang
张灯结彩	zhang deng jie cai
不解之缘	bu jie zhi yuan
无妄之灾	wu wang zhi zai
一头雾水	yi tou wu shui
千里迢迢	qian li tiao tiao
改朝换代	gai chao huan dai
热气腾腾	re qi teng teng
好景不长	hao jing bu chang
原原本本	yuan yuan ben ben
由小见大	you xiao jian da
屹立不动	yi li bu dong
鸡飞蛋打	ji fei dan da
大风大浪	da feng da lang
老谋深算	lao mou shen suan
抓耳挠腮	zhua er nao sai
一蹴而就	yi cu er jiu
明如指掌	ming ru zhi zhang
不相上下	bu xiang shang xia
完好无缺	wan hao wu que
舍生取义	she shen qu yi
时不我待	shi bu wo dai
一面之词	yi mian zhi ci
宽宏大量	kuan hong da liang
心烦意乱	xin fan yi luan
自投罗网	zi tou luo wang
逆流而上	ni liu er shang
眉开眼笑	mei kai yan xiao
惹火上身	re huo shang shen
狼心狗肺	lang xin gou fei
以讹传讹	yi e chuan e
毫不讳言	hao bu hui yan
追根溯源	zhui gen su yuan
以理服人	yi li fu ren
飞扬跋扈	fei yang ba hu
难分难舍	nan fen nan she
朴实无华	pu shi wu hua
接二连三	jie er lian san
自始至终	zi shi zhi zhong
狼狈不堪	lang bei bu kan
八面玲珑	ba mian ling long
普天同庆	pu tian tong qing
望尘不及	wang chen bu ji
唯唯诺诺	wei wei nuo nuo
张皇失措	zhang huang shi cuo
举棋不定	ju qi bu ding
左右逢源	zuo you feng yuan
大腹便便	da fu pian pian
衣锦还乡	yi jin huan xiang
风雨无阻	feng yu wu zu
掩人耳目	yan ren er mu
清正廉明	qing zheng lian ming
前因后果	qian yin hou guo
混水摸鱼	hun shui mo yu
千叮万嘱	qian ding wan zhu
若有若无	ruo you ruo wu
含辛茹苦	han xin ru ku
按部就班	an bu jiu ban
甘苦与共	gan ku yu gong
表里不一	biao li bu yi
刮目相待	gua mu xiang dai
祸不单行	huo bu dan xing
琅琅上口	lang lang shang kou
自力更生	zi li geng sheng
冰天雪地	bing tian xue di
人迹罕至	ren ji han zhi
真情实意	zhen qing shi yi
歪门邪道	wai men xie dao
南腔北调	nan qiang bei diao
火树银花	huo shu yin hua
叱咤风云	chi zha feng yun
欣喜若狂	xin xi ruo kuang
三言两语	san yan liang yu
藏龙卧虎	cang long wo hu
有口无心	you kou wu xin
扣人心弦	kou ren xin xian
坐享其成	zuo xiang qi cheng
单刀直入	dan dao zhi ru
麻木不仁	ma mu bu ren
自得其乐	zi de qi le
揭竿而起	jie gan er qi
不堪回首	bu kan hui shou
雕虫小技	diao chong xiao ji
遍体鳞伤	bian ti lin shang
一笑了之	yi xiao liao zhi
空话连篇	kong hua lian pian
飞沙走石	fei sha zou shi
叶公好龙	ye gong hao long
走马上任	zou ma shang ren
招摇撞骗	zhao yao zhuang pian
难能可贵	nan neng ke gui
变本加厉	bian ben jia li
不动声色	bu dong sheng se
所见略同	suo jian lue tong
支吾其词	zhi wu qi ci
迎头赶上	ying tou gan shang
病入膏肓	bing ru gao huang
完美无瑕	wan mei wu xia
正襟危坐	zheng jin wei zuo
年少气盛	nian shao qi sheng
死搬硬套	si ban ying tao
刚柔相济	gang rou xiang ji
安于现状	an yu xian zhuang
无理取闹	wu li qu nao
以防万一	yi fang wan yi
笑容可掬	xiao rong ke ju
其貌不扬	qi mao bu yang
恼羞成怒	nao xiu cheng nu
无缘无故	wu yuan wu gu
冤冤相报	yuan yuan xiang bao
克己奉公	ke ji feng gong
千奇百怪	qian qi bai guai
旁观者清	pang guan zhe qing
名不符实	ming bu fu shi
另辟蹊径	ling pi xi jing
神采奕奕	shen cai yi yi
依然如故	yi ran ru gu
不三不四	bu san bu si
养虎遗患	yang hu yi huan
前途渺茫	qian tu miao mang
顾影自怜	gu ying zi lian
各有所好	ge you suo hao
相视无言	xiang shi wu yan
睹物思人	du wu si ren
气喘吁吁	qi chuan xu xu
信口雌黄	xin kou ci huang
危如累卵	wei ru lei luan
坐吃山空	zuo chi shan kong
不约而同	bu yue er tong
稍逊一筹	shao xun yi chou
班门弄斧	ban men nong fu
油然而生	you ran er sheng
畏首畏尾	wei sho wei wei
耳闻目睹	er wen mu du
朝思暮想	zhao si mu xiang
独占鳌头	du zhan ao tou
好大喜功	hao da xi gong
星罗棋布	xing luo qi bu
虎落平阳	hu luo ping yang
踌躇不决	chou chu bu jue
奋发有为	fen fa you wei
千方百计	qian fang bai ji
抛头露面	pao tou lu mian
惊惶失措	jing huang shi cuo
心存芥蒂	xin cun jie di
妇孺皆知	fu ru jie zhi
隔墙有耳	ge qiang you er
束手就擒	shu shou jiu qin
不由分说	bu you fen shuo
应有尽有	ying you jin you
锲而不舍	qie er bu she
道听涂说	dao ting tu shuo
浩浩荡荡	hao hao dang dang
无米之炊	wu mi zhi chui
触景生情	chu jing sheng qing
以身作则	yi shen zuo ze
乌烟瘴气	wu yan zhang qi
进退维谷	jin tui wei gu
了如指掌	liao ru zhi zhang
专心一致	zhuan xin yi zhi
昙花一现	tan hua yi xian
忍无可忍	ren wu ke ren
真相大白	zhen xiang da bai
名副其实	ming fu qi shi
好吃懒做	hao chi lan zuo
群龙无首	qun long wu shou
居高临下	ju gao lin xia
令人神往	ling ren shen wang
独来独往	du lai du wang
大是大非	da shi da fei
下不为例	xia bu wei li
小试牛刀	xiao shi niu dao
金蝉脱壳	jin chan tuo qiao
同心同德	tong xin tong de
同仇敌忾	tong chou di kai
速战速决	su zhan su jue
大打出手	da da chu shou
轻举妄动	qing ju wang dong
胸无城府	xiong wu cheng fu
昏迷不醒	hun mi bu xing
草菅人命	cao jian ren ming
不自量力	bu zi liang li
初生之犊	chu sheng zhi du
劈荆斩棘	pi jing zhan ji
一团和气	yi tuan he qi
历历在目	li li zai mu
苦尽甘来	ku jin gan lai
长此以往	chang ci yi wang
同病相怜	tong bing xiang lian
乘风破浪	cheng feng po lang
生死攸关	sheng si you guan
逍遥自在	xiao yao zi zai
不假思索	bu jia si suo
大事化小	da shi hua xiao
天之骄子	tian zhi jiao zi
身历其境	shen li qi jing
抛砖引玉	pao zhuan yin yu
一语中的	yi yu zhong di
学无止境	xue wu zhi jing
燃眉之急	ran mei zhi ji
鸟语花香	niao yu hua xiang
不进则退	bu jin ze tui
神采焕发	shen cai huan fa
狼子野心	lang zi ye xin
浑然一体	hun ran yi ti
不成体统	bu cheng ti tong
苟且偷生	gou qie tou sheng
明察秋毫	ming cha qiu hao
高抬贵手	gao tai gui shou
众星拱月	zhong xing gong yue
推心置腹	tui xin zhi fu
狗急跳墙	gou ji tiao qiang
独木难支	du mu nan zhi
乐善好施	le shan hao shi
轻而易举	qing er yi ju
奋发向上	fen fa xiang shang
丰功伟绩	feng gong wei ji
以德报怨	yi de bao yuan
健步如飞	jian bu ru fei
事过境迁	shi guo jing qian
郁郁寡欢	yu yu gua huan
深得人心	shen de ren xin
顾虑重重	gu lu chong chong
夜长梦多	ye chang meng duo
轰动一时	hong dong yi shi
狼狈为奸	lang bei wei jian
白手成家	bai shou cheng jia
甘心情愿	gan xin qing yuan
强取豪夺	qiang qu hao duo
背井离乡	bei jing li xiang
举手之劳	ju shou zhi lao
豁然开朗	huo ran kai lang
人多势众	ren duo shi zhong
倒行逆施	dao xing ni shi
坚忍不拔	jian ren bu ba
默不作声	mo bu zuo sheng
引火烧身	yin huo shao shen
严惩不贷	yan cheng bu dai
顺水推舟	shun shui tui zhou
震天动地	zhen tian dong di
愚公移山	yu gong yi shan
不劳而获	bu lao er huo
求之不得	qiu zhi bu de
急起直追	ji qi zhi zhui
尖酸刻薄	jian suan ke bo
见财起意	jian cai qi yi
不言而喻	bu yan er yu
猝不及防	cu bu ji fang
略胜一筹	lue sheng yi chou
爱憎分明	ai zeng fen ming
伶牙利齿	ling ya li chi
误入歧途	wu ru qi tu
书香门第	shu xiang men di
眼花缭乱	yan hua liao luan
见机而行	jian ji er xing
假公济私	jia gong ji si
内外夹攻	nei wai jia gong
一片丹心	yi pian dan xin
凤毛麟角	feng mao lin jiao
涉世未深	she shi wei shen
投桃报李	tou tao bao li
勤勤恳恳	qin qin ken ken
任人摆布	ren ren bai bu
天各一方	tian ge yi fang
化险为夷	hua xian wei yi
日夜兼程	ri ye jian cheng
力所不及	li suo bu ji
贪心不足	tan xin bu zu
虚无缥缈	xu wu piao miao
不负众望	bu fu zhong wang
大有人在	da you ren zai
可歌可泣	ke ge ke qi
对症下药	dui zheng xia yao
动人心弦	dong ren xin xian
感激不尽	gan ji bu jin
邯郸学步	han dan xue bu
甜酸苦辣	tian suan ku la
猴年马月	hou nian ma yue
子虚乌有	zi xu wu you
花落谁家	hua luo shui jia
有张有弛	you zhang you chi
精诚团结	jing cheng tuan jie
鱼贯而出	yu guan er chu
表里如一	biao li ru yi
身心交瘁	shen xin jiao cui
坚不可摧	jian bu ke cui
山重水复	shan chong shui fu
心惊胆颤	xin jing dan chan
无的放矢	wu di fang shi
全力以赴	quan li yi fu
拍手称快	pai shou cheng kuai
阴差阳错	yin cha yang cuo
说一不二	shuo yi bu er
天生丽质	tian sheng li zhi
故弄玄虚	gu nong xuan xu
风和日丽	feng he ri li
左右为难	zuo you wei nan
安如泰山	an ru tai shan
任重道远	ren zhong dao yuan
精疲力竭	jing pi li jie
盆满钵满	pen man bo man
接踵而来	jie zhong er lai
血流成河	xue liu cheng he
势均力敌	shi jun li di
胸无大志	xiong wu da zhi
省吃俭用	sheng chi jian yong
求新立异	qiu xin li yi
无所不晓	wu suo bu xiao
大有作为	da you zuo wei
想入非非	xiang ru fei fei
一见倾心	yi jian qing xin
面红耳赤	mian hong er chi
死有余辜	si you yu gu
自惭形秽	zi can xing hui
卑鄙无耻	bei bi wu chi
心急如火	xin ji ru huo
畅行无阻	chang xing wu zu
死里逃生	si li tao sheng
杂乱无章	za luan wu zhang
走为上策	zou wei shang ce
胡思乱想	hu si luan xiang
疾恶如仇	ji e ru chou
万全之策	wan quan zhi ce
众矢之的	zhong shi zhi di
拖泥带水	tuo ni dai shui
百年好合	bai nian hao he
寸草不留	cun cao bu liu
忧国忧民	you guo you min
勤俭节约	qin jian jie yue
十全十美	shi quan shi mei
灯红酒绿	deng hong jiu lu
悲观失望	bei guan shi wang
患难之交	huan nan zhi jiao
紧追不舍	jin zhui bu she
业精于勤	ye jing yu qin
光明磊落	guang ming lei luo
志存高远	zhi cun gao yuan
落英缤纷	luo ying bin fen
身不由主	shen bu you zhu
气象万千	qi xiang wan qian
望而生畏	wang er sheng wei
一望无边	yi wang wu bian
盖棺定论	gai guan ding lun
门庭若市	men ting ruo shi
得不偿失	de bu chang shi
串通一气	chuan tong yi qi
别出心裁	bie chu xin cai
烟消云散	yan xiao yun san
如火燎原	ru huo liao yuan
水洩不通	shui xie bu tong
承先启后	cheng xian qi hou
义愤填膺	yi fen tian ying
理直气壮	li zhi qi zhuang
于心有愧	yu xin you kui
孺子可教	ru zi ke jiao
锣鼓喧天	luo gu xuan tian
毫无逊色	hao wu xun se
反复无常	fan fu wu chang
怡然自得	yi ran zi de
国富民强	guo fu min qiang
就事论事	jiu shi lun shi
熟视无睹	shu shi wu du
无可救药	wu ke jiu yao
痛定思痛	tong ding si tong
安居乐业	an ju le ye
狡兔三窟	jiao tu san ku
近在眉睫	jin zai mei jie
巧舌如簧	qiao she ru huang
自由自在	zi you zi zai
一败涂地	yi bai tu di
俯首贴耳	fu shou tie er
否极泰来	pi ji tai lai
因小失大	yin xiao shi da
馋涎欲滴	chan xian yu di
欺人太甚	qi ren tai shen
成家立业	cheng jia li yie
情深义重	qing shen yi zhong
一模一样	yi mo yi yang
强加于人	qiang jia yu ren
以点带面	yi dian dai mian
按步就班	an bu jiu ban
携手并肩	xie shou bing jian
自学成才	zi xue cheng cai
毁于一旦	hui yu yi dan
跋山涉水	ba shan she shui
白璧无瑕	bai bi wu xia
一箭双雕	yi jian shuang diao
力不从心	li bu cong xin
纷纷扬扬	fen fen yang yang
目空一切	mu kong yi qie
留恋不舍	liu lian bu she
力所能及	li suo neng ji
与时俱进	yu shi ju jin
六神无主	liu shen wu zhu
调虎离山	diao hu li shan
空空如也	kong kong ru ye
胆小如鼠	dan xiao ru shu
不欢而散	bu huan er san
如履薄冰	ru lu bo bing
心灰意冷	xin hui yi leng
不可限量	bu ke xian liang
面目一新	mian mu yi xin
词不达意	ci bu da yi
有所作为	you suo zuo wei
知难而进	zhi nan er jin
功成名就	gong cheng ming jiu
玩物丧志	wan wu sang zhi
销声匿迹	xiao sheng ni ji
鼎力相助	ding li xiang zhu
前程万里	qian cheng wan li
弃恶从善	qi e cong shan
牛毛细雨	niu mao xi yu
身无分文	shen wu fen wen
作奸犯科	zuo jian fan ke
懵头转向	meng tou zhuan xiang
大智如愚	da zhi ru yu
动之以情	dong zhi yi qing
有备无患	you bei wu huan
一了百了	yi liao bai liao
臭名远扬	chou ming yuan yang
孤掌难鸣	gu zhang nan ming
瓮中捉鳖	weng zhong zhuo bie
杞人忧天	qi ren you tian
披荆斩棘	pi jing zhan ji
奋勇争先	fen yong zheng xian
焦躁不安	jiao zao bu an
不平则鸣	bu ping ze ming
远近闻名	yuan jin wen ming
温文尔雅	wen wen er ya
欢欣若狂	huan xin ruo kuang
手足无措	shou zu wu cuo
不亢不卑	bu kang bu bei
是非分明	shi fei fen ming
棋逢敌手	qi feng di shou
混淆黑白	hun xiao hei bai
名实相符	ming shi xiang fu
先苦后甜	xian ku hou tian
一曝十寒	yi pu shi han
声情并茂	sheng qing bing mao
当仁不让	dang ren bu rang
赏罚不明	shang fa bu ming
两小无猜	liang xiao wu cai
一望而知	yi wang er zhi
胡搅蛮缠	hu jiao man chan
应接不暇	ying jie bu xia
含血喷人	han xue pen ren
贪小失大	tan xiao shi da
嚎啕大哭	hao tao da ku
当家做主	dang jia zuo zhu
公诸于世	gong zhu yu shi
满目疮痍	man mu chuang yi
义无反顾	yi wu fan gu
横加指责	heng jia zhi ze
出言不逊	chu yan bu xun
甘拜下风	gan bai xia feng
大智如愚	da zhi ru yu
昏天黑地	hun tian hei di
心急火燎	xin ji huo liao
不成方圆	bu cheng fang yuan
艺高胆大	yi gao dan da
手到拈来	shou dao nian lai
杯弓蛇影	bei gong she ying
刻骨铭心	ke gu ming xin
昼思夜想	zhou si ye xiang
琅琅上口	lang lang shang kou
号啕大哭	hao tao da ku
命在旦夕	ming zai dan xi
送旧迎新	song jiu ying xin
自欺欺人	zi qi qi ren
直抒胸臆	zhi shu xiong yi
无功而返	wu gong er fan
众目睽睽	zhong mu kui kui
见怪不怪	jian guai bu guai
洗耳恭听	xi er gong ting
势不可挡	shi bu ke dang
美不胜收	mei bu sheng shou
步履维艰	bu lu wei jian
后患无穷	hou huan wu qiong
苦尽甜来	ku jin tian lai
短小精悍	duan xiao jing han
造化弄人	zao hua nong ren
两面三刀	liang mian san dao
不辞辛劳	bu ci xin lao
屡战屡败	lu zhan lu bai
破镜重圆	po jing chong yuan
祸福相依	huo fu xiang yi
银装素裹	yin zhuanɡ su ɡuo
化为灰烬	hua wei hui jin
人各有志	ren ge you zhi
心地善良	xin di shan liang
品学兼优	pin xue jian you
略知一二	lue zhi yi er
四面八方	si mian ba fang
邪不胜正	xie bu sheng zheng
疑惑不解	yi huo bu jie
反客为主	fan ke wei zhu
有机可乘	you ji ke cheng
先发制人	xian fa zhi ren
凶相毕露	xiong xiang bi lu
从容应对	cong rong ying dui
温故知新	wen gu zhi xin
视为儿戏	shi wei er xi
兴旺发达	xing wang fa da
日复一日	ri fu yi ri
有名无实	you ming wu shi
反唇相讥	fan chun xiang ji
层出不穷	ceng chu bu qiong
汗马功劳	han ma gong lao
货真价实	huo zhen jia shi
火上浇油	huo shang jiao you
有心无力	you xin wu li
瓜田李下	gua tian li xia
自身难保	zi shen nan bao
五颜六色	wu yan liu se
承上启下	cheng shang qi xia
无所畏惧	wu suo wei ju
故步自封	gu bu zi feng
绝处逢生	jue chu feng sheng
上行下效	shang xing xia xiao
勃然变色	bo ran bian se
大有起色	da you qi se
眉飞色舞	mei fei se wu
积沙成塔	ji sha cheng ta
众叛亲离	zhong pan qin li
另眼看待	ling yan kan dai
碌碌无为	lu lu wu wei
包罗万象	bao luo wan xiang
吐故纳新	tu gu na xin
兵荒马乱	bing huang ma luan
身先士卒	shen xian shi zu
独具慧眼	du ju hui yan
神来之笔	shen lai zhi bi
铜墙铁壁	tong qiang tie bi
一板一眼	yi ban yin yan
狼狈逃窜	lang bei tao cuan
哭笑不得	ku xiao bu de
无所事事	wu suo shi shi
魂不附体	hun bu fu ti
乐不可支	le bu ke zhi
大显神通	da xian shen tong
以逸待劳	yi yi dai lao
洗心革面	xi xin ge mian
筋疲力尽	jing pi li jin
披沙拣金	pi sha jian jin
一言一行	yi yan yi xing
文人相轻	wen ren xiang qing
无事生非	wu shi sheng fei
从容自如	cong rong zi ru
意味深长	yi wei shen chang
满盘皆输	man pan jie shu
声名鹊起	sheng ming que qi
不堪入目	bu kan ru mu
枉费工夫	wang fei gong fu
作茧自缚	zuo jian zi fu
举世闻名	ju shi wen ming
杀一儆百	sha yi jing bai
空头支票	kong tou zhi piao
狼子野心	lang zi ye xin
天真烂漫	tian zhen lan man
自卖自夸	zi mai zi kua
从天而降	cong tian er jiang
情有可原	qing you ke yuan
闻风而起	wen feng er qi
皆大欢喜	jie da huan xi
忆苦思甜	yi ku si tian
滴水不漏	di shui bu lou
话不投机	hua bu tou ji
如临大敌	ru lin da di
大惊小怪	da jing xiao guai
闻名遐迩	wen ming xia er
一线生机	yi xian sheng ji
动荡不安	dong dang bu an
水来土掩	shui lai tu yan
大展宏图	da zhan hong tu
声色俱厉	sheng se ju li
小肚鸡肠	xiao du ji chang
千篇一律	qian pian yi lu
震耳欲聋	zhen er yu long
妙手回春	miao shou hui chun
一往直前	yi wang zhi qian
能工巧匠	neng gong qiao jiang
不可一世	bu ke yi shi
先来后到	xian lai hou dao
殃及池鱼	yang ji chi yu
残缺不全	can que bu quan
风尘仆仆	feng chen pu pu
厚此薄彼	hou ci bo bi
矫枉过正	jiao wang guo zheng
夜以继日	ye yi ji ri
视死如归	shi si ru gui
心不在焉	xin bu zai yan
大街小巷	da jie xiao xiang
无所不在	wu suo bu zai
以貌取人	yi mao qu ren
三三两两	san san liang liang
青红皂白	qing hong zao bai
与众不同	yu zhong bu tong
失之交臂	shi zhi jiao bi
牛刀小试	niu dao xiao shi
殚精竭虑	dan jing jie lu
于事无补	yu shi wu bu
礼贤下士	li xian xia shi
登高望远	deng gao wang yuan
纵横交错	zong heng jiao cuo
杀鸡取卵	sha ji qu luan
名列前茅	ming lie qian mao
能言善道	neng yan shan dao
陈词滥调	chen ci lan diao
添枝加叶	tian zhi jia ye
混作一谈	hun zuo yi tan
因循守旧	yin xun shou jiu
一息尚存	yi xi shang cun
面有难色	mian you nan se
乐在其中	le zai qi zhong
马到成功	ma dao cheng gong
珠联璧合	zhu lian bi he
打马虎眼	da ma hu yan
精神抖擞	jing shen dou sou
不屑一顾	bu xie yi gu
轻重倒置	qing zhong dao zhi
精神焕发	jing shen huan fa
袖手旁观	xiu shou pang guan
知无不言	zhi wu bu yan
铤而走险	ting er zou xian
铸成大错	zhu cheng da cuo
善罢甘休	shan ba gan xiu
漫无边际	man wu bian ji
一字千金	yi zi qian jin
朴素无华	pu su wu hua
乔迁之喜	qiao qian zhi xi
千疮百孔	qian chuang bai kong
暗无天日	an wu tian ri
小恩小惠	xiao en xiao hui
置若罔闻	zhi ruo wang wen
渺无音讯	miao wu yin xun
非分之想	fei fen zhi xiang
口齿伶俐	kou chi ling li
你死我活	ni si wo huo
生财有道	sheng cai you dao
昂首挺胸	ang shou ting xiong
茁壮成长	zhuo zhuang cheng zhang
言简意赅	yan jian yi gai
愁眉不展	chou mei bu zhan
前途渺茫	qian tu miao mang
不屑置辩	bu xie zhi bian
恶语伤人	e yu shang ren
装疯卖傻	zhuang feng mai sha
卷土重来	juan tu chong lai
不了了之	bu liao liao zhi
生死存亡	sheng si cun wang
后悔莫及	hou hui mo ji
盲人摸象	mang ren mo xiang
若无其事	ruo wu qi shi
称心如意	chen xin ru yi
只手遮天	zhi shou zhe tian
相去无几	xiang qu wu ji
大错特错	da cuo te cuo
言行不符	yan xing bu fu
浑身解数	hun shen xie shu
势在必行	shi zai bi xing
倒背如流	dao bei ru liu
一言为定	yi yan wei ding
活灵活现	huo ling huo xian
小惩大诫	xiao cheng da jie
巧取豪夺	qiao qu hao duo
鸟尽弓藏	niao jin gong cang
情景交融	qing jing jiao rong
奋勇前进	fen yong qian jin
轰轰烈烈	hong hong lie lie
遥相呼应	yao xiang hu ying
论功行赏	lun gong xing shang
精美绝伦	jing mei jue lun
谢天谢地	xie tian xie di
目瞪口呆	mu deng kou dai
生死之交	sheng si zhi jiao
知足常乐	zhi zu chang le
教学相长	jiao xue xiang zhang
提心吊胆	ti xin diao dan
栋梁之才	dong liang zhi cai
为民除害	wei min chu hai
不骄不躁	bu jiao bu zao
欢蹦乱跳	huan beng luan tiao
铲草除根	chan cao chu gen
饮鸩止渴	yin zhen zhi ke
大起大落	da qi da luo
畏缩不前	wei suo bu qian
无忧无虑	wu you wu lu
疾风骤雨	ji feng zhou yu
妙语连珠	miao yu lian zhu
改过自新	gai guo zi xin
英雄好汉	ying xiong hao han
畏缩不前	wei suo bu qian
混为一谈	hun wei yi tan
投其所好	tou qi suo hao
怒火中烧	nu huo zhong shao
敷衍塞责	fu yan se ze
年少无知	nian shao wu zhi
原封不动	yuan feng bu dong
穷途末路	qiong tu mo lu
功亏一篑	gong kui yi kui
壮志未酬	zhuang zhi wei chou
万无一失	wan wu yi shi
精卫填海	jing wei tian hai
济济一堂	ji ji yi tang
急中生智	ji zhong sheng zhi
经年累月	jing nian lei yue
漏洞百出	lou dong bai chu
眼不转睛	yan bu zhuan jing
瑕不掩瑜	xia bu yan yu
屡试不爽	lu shi bu shuang
狗仗人势	gou zhang ren shi
风靡一时	feng mi yi shi
集思广益	ji si guang yi
过目不忘	guo mu bu wang
响彻云霄	xiang che yun xiao
世人皆知	shi ren jie zhi
一无所成	yi wu suo cheng
独步天下	du bu tian xia
举止大方	ju zhi da fang
事必躬亲	shi bi gong qin
趋炎附势	qu yan fu shi
金玉满堂	jin yu man tang
标新立异	biao xin li yi
助人为乐	zhu ren wei le
大快人心	da kuai ren xin
自私自利	zi si zi li
一心两用	yi xin liang yong
心明眼亮	xin ming yan liang
因人而异	yin ren er yi
赞不绝口	zan bu jue kou
人财两空	ren cai liang kong
孤立无援	gu li wu yuan
捉襟见肘	zhuo jin jian zhou
流离失所	liu li shi suo
卓尔不群	zhuo er bu qun
化险为夷	hua xian wei yi
积少成多	ji shao cheng duo
从轻发落	cong qing fa luo
大发慈悲	da fa ci bei
相提并论	xiang ti bing lun
势均力敌	shi jun li di
呼之欲出	hu zhi yu chu
满载而归	man zai er gui
呼朋唤友	hu peng huan you
石沉大海	shi chen da hai
行云流水	xing yun liu shui
始料不及	shi liao bu ji
争名逐利	zheng ming zhu li
瑕不掩瑜	xia bu yan yu
抑扬顿挫	yi yang dun cuo
大有起色	da you qi se
大费周折	da fei zhou zhe
骨肉相连	gu rou xiang lian
咬文嚼字	yao wen jiao zi
赏罚严明	shang fa yan ming
浪迹天涯	lang ji tian ya
改恶从善	gai e cong shan
牛鬼蛇神	niu gui she shen
无声无息	wu sheng wu xi
用心良苦	yong xin liang ku
畅所欲言	chang suo yu yan
泪流满面	lei liu man mian
忙里偷闲	mang li tou xian
分一杯羹	fen yi bei geng
文如其人	wen ru qi ren
先见之明	xian jian zhi ming
杳无音讯	yao wu yin xun
急于求成	ji yu qiu cheng
纷至沓来	fen zhi ta lai
来者不善	lai zhe bu shan
呆如木鸡	dai ru mu ji
花好月圆	hua hao yue yuan
挥洒自如	hui sa zi ru
临阵磨枪	lin zhen mo qiang
风驰电掣	feng chi dian che
声如洪钟	sheng ru hong zhong
相敬如宾	xiang jing ru bin
一锤定音	yi chui ding yin
头破血流	tou po xue liu
不疾不徐	bu ji bu xu
尽善尽美	jin shan jin mei
悲天悯人	bei tian min ren
毫不犹豫	hao bu you yu
层次分明	ceng ci fen ming
察颜观色	cha yan guan se
咎由自取	jiu you zi qu
生生不息	sheng sheng bu xi
十恶不赦	shi e bu she
分庭抗礼	fen ting kang li
泰然自若	tai ran zi ruo
遗患无穷	yi huan wu qiong
严于律己	yan yu lu ji
蓬头垢面	peng tou gou mian
口干舌燥	kou gan she zao
正颜厉色	zheng yan li se
毫不相干	hao bu xiang gan
绝无仅有	jue wu jin you
粗制滥造	cu zhi lan zao
所作所为	suo zuo suo wei
弱不禁风	ruo bu jin feng
热火朝天	re huo chao tian
不可动摇	bu ke dong yao
敢作敢为	gan zuo gan wei
人心难测	ren xin nan ce
塞翁失马	sai weng shi ma
姹紫嫣红	cha zi yan hong
转弯抹角	zhuan wan mo jiao
逆耳忠言	ni er zhong yan
无情无义	wu qing wu yi
难上加难	nan shang jia nan
别有天地	bie you tian di
挺身而出	ting shen er chu
真心诚意	zhen xin cheng yi
不攻自破	bu gong zi po
夺门而出	duo men er chu
从善如流	cong shan ru liu
闻一知十	wen yi zhi shi
身体力行	shen ti li xing
视若儿戏	shi ruo er xi
尽心尽力	jin xin jin li
含沙射影	han sha she ying
当机立断	dang ji li duan
朝令暮改	zhao ling mu gai
炯炯有神	jiong jiong you shen
大有可为	da you ke wei
迷途知返	mi tu zhi fan
聪明绝顶	cong ming jue ding
坐失良机	zuo shi liang ji
分崩离析	fen beng li xi
风云变幻	feng yun bia huan
不知好歹	bu zhi hao dai
无私无畏	wu si wu wei
心慈手软	xin ci shou ruan
大呼小叫	da hu xiao jiao
火中取栗	huo zhong qu li
屈指可数	qu zhi ke shu
水滴石穿	shui di shi chuan
有条不紊	you tiao bu wen
满城风雨	man cheng feng yu
义不容辞	yi bu rong ci
玉树临风	yu shu lin feng
长话短说	chang hua duan shuo
扬长而去	yang chang er qu
小鸟依人	xiao niao yi ren
不可辩驳	bu ke bian bo
替天行道	ti tian xing dao
坐而论道	zuo er lun dao
水涨船高	shui zhang chuan gao
铁杵磨针	tie chu mo zhen
娓娓而谈	wei wei er tan
决胜千里	jue sheng qian li
物归原主	wu gui yuan zhu
百废待兴	bai fei dai xing
空洞无物	kong dong wu wu
堆积成山	dui ji cheng shan
相濡以沫	xiang ru yi mo
犹豫不定	you yu bu ding
如日中天	ru ri zhong tian
兴高采烈	xing gao cai lie
十面埋伏	shi mian mai fu
得寸进尺	de cun jin chi
严阵以待	yan zhen yi dai
鱼贯而行	yu guan er xing
无可非议	wu ke fei yi
良师益友	liang shi yi you
反败为胜	fan bai wei sheng
神气十足	shen qi shi zu
耳提面命	er ti mian ming
短小精干	duan xiao jing gan
唯妙唯肖	wei miao wei xiao
两虎相斗	liang hu xiang dou
孤家寡人	gu jia gua ren
口如悬河	kou ru xuan he
自相残杀	zi xiang can sha
贼喊捉贼	zei han zhuo zei
枪林弹雨	qiang lin dan yu
望尘莫及	wang chen mo ji
坚苦卓绝	jian ku zhuo jue
各抒己见	ge shu ji jian
举世无双	ju shi wu shuang
不遗余力	bu yi yu li
药到病除	yao dao bing chu
头晕眼花	tou yun yan hua
大有人在	da you ren zai
哀鸿遍地	ai hong bian di
怒不可遏	nu bu ke e
视同手足	shi tong shou zu
明辨是非	ming bian shi fei
难以挽回	nan yi wan hui
畏首畏尾	wei sho wei wei
一网打尽	yi wang da jin
口若悬河	kou ruo xuan he
装腔作势	zhuang qiang zuo shi
乐不思蜀	le bu si shu
一丝不苟	yi si bu gou
置之度外	zhi zhi du wai
无所不为	wu suo bu wei
粗枝大叶	cu zhi da ye
莘莘学子	shen shen xue zi
失而复得	shi er fu de
胆战心惊	dan zhan xin jing
鼠目寸光	shu mu cun guang
毫不在意	hao bu zai yi
刀光剑影	dao guang jian ying
聪明才智	cong ming cai zhi
变化多端	bian hua duo duan
见微知著	jian wei zhi zhu
不甘后人	bu gan hou ren
和蔼可亲	he ai ke qin
举世瞩目	ju shi zhu mu
力不能及	li bu neng ji
唉声叹气	ai sheng tan qi
汗流浃背	han liu jia bei
如愿以偿	ru yuan yi chang
不堪一击	bu kan yi ji
欢呼雀跃	huan hu que yue
势如破竹	shi ru po zhu
束手待毙	shu shou dai bi
冰山一角	bing shan yi jiao
后起之秀	hou qi zhi xiu
夜不闭户	ye bu bi hu
真心诚意	zhen xin cheng yi
童叟无欺	tong sou wu qi
垂死挣扎	chui si zheng zha
金碧辉煌	jin bi hui huang
不共戴天	bu gong dai tian
事不过三	shi bu guo san
横七竖八	heng qi shu ba
劳而无功	lao er wu gong
光明正大	guang ming zheng da
太平盛世	tai ping sheng shi
情同手足	qing tong shou zu
人小鬼大	ren xiao gui da
文不对题	wen bu dui ti
心乱如麻	xin luan ru ma
话中有话	hua zhong you hua
融会贯通	rong hui guan tong
冰雪聪明	bing xue cong ming
狐假虎威	hu jia hu wei
聚精会神	ju jing hui shen
生气勃勃	sheng qi bo bo
朝三暮四	zhao san mu si
不理不睬	bu li bu cai
始终不渝	shi zhong bu yu
乘其不备	cheng qi bu bei
低头丧气	di tou sang qi
前呼后拥	qian hu hou yong
自相矛盾	zi xiang mao dun
后继有人	hou ji you ren
倾盆大雨	qing pen da yu
英姿勃发	ying zi bo fa
卧薪尝胆	wo xin chang dan
英雄辈出	ying xong bei chu
一拥而上	yi yong er shang
专心致志	zhuan xin zhi zhi
一拍即合	yi pai ji he
朗朗上口	lang lang shang kou
知书达礼	zhi shu da li
人声鼎沸	ren sheng ding fei
一往无前	yi wang wu qian
大材小用	da cai xiao yong
棋高一着	qi gao yi zhao
十拿九稳	shi na jiu wen
邪不压正	xie bu ya zheng
众说纷纭	zhong shuo fen yun
击中要害	ji zhong yao hai
强人所难	qiang ren suo nan
妄自菲薄	wang zi fei bo
人人皆知	ren ren jie zhi
宁缺勿滥	ning que wu lan
一举一动	yi ju yi dong
谈虎色变	tan hu se bian
笑容满面	xiao rong man mian
班门弄斧	ban men nong fu
泪如泉涌	lei ru quan yong
聪明伶俐	cong ming ling li
近朱者赤	jin zhu zhe chi
长吁短叹	chang xu duan tan
养尊处优	yang zun chu you
楚楚可怜	chu chu ke lian
乐极生悲	le ji sheng bei
若隐若现	ruo yin ruo xian
一唱一和	yi chang yi he
前思后想	qian si hou xiang
铭心刻骨	ming xin ke gu
分文不取	fen wen bu qu
怨天尤人	yuan tian you ren
天下无双	tian xia wu shuang
如醉如痴	ru zui ru chi
习以为常	xi yi wei chang
另当别论	ling dang bie lun
略见一斑	lue jian yi ban
波澜不惊	bo lan bu jing
津津有味	jin jin you wei
乱作一团	luan zuo yi tuan
死去活来	si qu huo lai
囊中羞涩	nang zhong xiu se
分门别类	fen men bie lei
平心静气	ping xin jing qi
价值连城	jia zhi lian cheng
义正词严	yi zheng ci yan
以弱胜强	yi ruo sheng qiang
贪得无厌	tan de wu yan
甘苦与共	gan ku yu gong
鼓舞人心	gu wu ren xin
横冲直撞	heng chong zhi zhuang
优哉游哉	you zai you zai
一臂之力	yi bi zhi li
沾沾自喜	zhan zhan zi xi
人满为患	ren man wei huan
百口莫辩	bai kou mo bian
笨鸟先飞	ben niao xian fei
取长补短	qu chang bu duan
力排众议	li pai zhong yi
美中不足	mei zhong bu zu
见风转舵	jian feng zhuan duo
生死与共	sheng si yu gong
肝肠寸断	gan chang cun duan
生离死别	sheng li si bie
感恩图报	gan en tu bao
天高地厚	tian gao di hou
虎口逃生	hu kou tao sheng
非亲非故	fei qin fei gu
不闻不问	bu wen bu wen
精益求精	jing yi qiu jing
前仆后继	qian pu hou ji
半夜三更	ban ye san geng
扑朔迷离	pu shuo mi li
漫山遍野	man shan bian ye
枯木逢春	ku mu feng chun
谆谆告诫	zhun zhun gao jie
半斤八两	ban jin ba liang
光怪陆离	guang guai lu li
稳如泰山	wen ru tai shan
水土不服	shui tu bu fu
如痴似醉	ru chi si zui
难以置信	nan yi zhi xin
遗臭万年	yi chou wan nian
一泻千里	yi xie qian li
谋事在人	mou shi zai ren
宠辱不惊	chong ru bu jing
自高自大	zi gao zi da
此起彼伏	ci qi bi fu
痛定思痛	tong ding si tong
深信不疑	shen xin bu yi
直抒己见	zhi shu ji jian
不置可否	bu zhi ke fou
穷根究底	qiong gen jiu di
埋头苦干	mai tou ku gan
公之于众	gong zhi yu zhong
半推半就	ban tui ban jiu
悔恨交加	hui hen jiao jia
万事如意	wan shi ru yi
大气磅礴	da qi pang bo
少见多怪	shao jian duo guai
竹篮打水	zhu lan da shui
不胜其烦	bu sheng qi fan
言多必失	yan duo bi shi
不折不扣	bu zhe bu kou
开阔眼界	kai kuo yan jie
力尽筋疲	li jin jin pi
出尔反尔	chu er fan er
经久不息	jing jiu bu xi
留连忘返	liu lian wang fan
甜酸苦辣	tian suan ku la
早出晚归	zao chu wan gui
良莠不齐	liang you bu qi
久而久之	jiu er jiu zhi
由近及远	you jin ji yuan
围魏救赵	wei wei jiu zhao
猫哭耗子	mao ku hao zi
一表人才	yi biao ren cai
抱头鼠窜	bao tou shu cuan
发扬光大	fa yang guang da
借花献佛	jie hua xian fo
计上心来	ji shang xin lai
一掷千金	yi zhi qian jin
以少胜多	yi shao sheng duo
一语破的	yi yu po di
自给自足	zi ji zi zu
违法乱纪	wei fa luan ji
扭捏作态	niu nie zuo tai
蜂拥而至	feng yong er zhi
自知之明	zi zhi zhi ming
和而不同	he er bu tong
粉身碎骨	fen shen sui gu
兴风作浪	xing feng zuo lang
大手大脚	da shou da jiao
倚老卖老	yi lao mai lao
迫不得已	po bu de yi
贼眉鼠眼	zei mei shu yan
坦然自若	tan ran zi ruo
饱经风霜	bao jing feng shuang
兵不血刃	bing bu xue ren
望洋兴叹	wang yang xing tan
迫不及待	po bu ji dai
果不其然	guo bu qi ran
大言不惭	da yan bu can
网开一面	wang kai yi mian
操之过急	cao zhi guo ji
百折不回	bai zhe bu hui
出奇制胜	chu qi zhi sheng
根深蒂固	gen shen di gu
挑三拣四	tiao san jian si
天生丽质	tian sheng li zhi
横生枝节	heng sheng zhi jie
风雨同舟	feng yu tong zhou
微不足道	wei bu zu dao
畅通无阻	chang tong wu zu
万里无云	wan li wu yun
花团锦簇	hua tuan jin cu
返朴归真	fan pu gui zhen
毫不介意	hao bu jie yi
学识渊博	xue shi yuan bo
金玉良言	jin yu liang yan
投机取巧	tou ji qu qiao
螳螂捕蝉	tang lang bu chan
饥寒交迫	ji han jiao po
此起彼落	ci qi bi luo
得意之色	de yi zhi se
活龙活现	huo long huo xian
姑息养奸	gu xi yang jian
拔苗助长	ba miao zhu zhang
势如水火	shi ru shui huo
始作俑者	shi zuo yong zhe
无中生有	wu zhong sheng you
斗转星移	dou zhuan xing yi
有志竟成	you zhi jing cheng
有情有义	you qing you yi
归根结蒂	gui gen jie di
鞠躬尽瘁	ju gong jin cui
画龙点睛	hua long dian jing
怒形于色	nu xing yu se
绞尽脑汁	jiao jin nao zhi
大相径庭	da xiang jing ting
暗箭伤人	an jian shang ren
同心协力	tong xin xie li
敢作敢当	gan zuo gan dang
斩钉截铁	zhan ding jie tie
不计其数	bu ji qi shu
不足挂齿	bu zu gua chi
自取灭亡	zi qu mie wang
青史留名	qing shi liu ming
宁缺毋滥	ning que wu lan
按图索骥	an tu suo ji
挥汗如雨	hui han ru yu
积习难改	ji xi nan gai
言不由衷	yan bu you zhong
坚定不移	jian ding bu yi
源源不断	yuan yuan bu duan
害人不浅	hai ren bu qian
爱财如命	ai cai ru ming
侃侃而谈	kan kan er tan
呕心沥血	ou xin li xue
天伦之乐	tian lun zhi le
天壤之别	tian rang zhi bie
冷嘲热讽	leng chao re feng
生机盎然	sheng ji ang ran
会心一笑	hui xin yi xiao
咄咄逼人	duo duo bi ren
淋漓尽致	lin li jin zhi
疾言厉色	ji yan li se
新陈代谢	xin chen dai xie
大步流星	da bu liu xing
以退为进	yi tui wei jin
牙牙学语	ya ya xue yu
力挽狂澜	li wan kuang lan
远近驰名	yuan jin chi ming
首屈一指	shou qu yi zhi
毛手毛脚	mao shou mao jiao
茶余饭后	cha yu fan hou
面黄肌瘦	mian huang ji shou
釜底抽薪	fu di chou xin
何去何从	he qu he cong
飘洋过海	piao yang guo hai
低声下气	di sheng xia qi
三五成群	san wu cheng qun
出神入化	chu shen ru hua
多此一举	duo ci yi ju
醉生梦死	zui sheng meng si
溃不成军	kui bu cheng jun
勾心斗角	gou xin dou jiao
无牵无挂	wu qian wu gua
无踪无影	wu zong wu ying
以防未然	yi fang wei ran
天翻地覆	tian fan di fu
望子成龙	wang zi cheng long
千山万水	qian shan wan shui
口快心直	kou kuai xin zhi
应运而生	ying yun er sheng
疑神疑鬼	yi shen yi gui
是非曲直	shi fei qu zhi
含糊其辞	han hu qi ci
转悲为喜	zhuan bei wei xi
高谈阔论	gao tan kuo lun
眉清目秀	mei qing mu xiu
胆大妄为	dan da wang wei
心力交瘁	xin li jiao cui
电闪雷鸣	dian shan lei ming
心潮澎湃	xin chao peng pai
才高八斗	cai gao ba dou
毛骨悚然	mao gu song ran
蚍蜉撼树	pi fu han shu
半真半假	ban zhen ban jia
开天辟地	kai tian pi di
对号入座	dui hao ru zuo
精疲力尽	jing pi li jin
无与伦比	wu yu lun bi
俯拾即是	fu shi ji shi
和衷共济	he zhong gong ji
病从口入	bing cong kou ru
繁荣昌盛	fan rong chang sheng
乐此不疲	le ci bu pi
娇小玲珑	jiao xiao ling long
追根寻底	zhui gen xun di
百炼成钢	bai lian cheng gang
危言耸听	wei yan song ting
见缝插针	jian feng cha zhen
顺理成章	shun li cheng zhang
平平淡淡	ping ping dan dan
瘦骨嶙峋	shou gu lin xun
惊弓之鸟	jing gong zhi niao
春风化雨	chun feng hua yu
目不暇接	mu bu xia jie
居功自傲	ju gong zi ao
虽死犹荣	sui si you rong
不依不饶	bu yi bu rao
沧海桑田	cang hai sang tian
急如星火	ji ru xing huo
千头万绪	qian tou wan xu
锦绣前程	jin xiu qian cheng
一清二白	yi qing er bai
容光焕发	rong guang huan fa
万象更新	wan xiang geng xin
欲言又止	yu yan you zhi
年富力强	nian fu li qiang
死得其所	si de qi suo
七窍生烟	qi qiao sheng yan
小试锋芒	xiao shi feng mang
年轻气盛	nian qing qi sheng
左膀右臂	zuo bang you bi
相逢恨晚	xiang feng hen wan
前车之鉴	qian che zhi jian
发奋图强	fa fen tu qiang
归根结底	gui gen jie di
见智见仁	jian zhi jian ren
自成一家	zi cheng yi jia
喜上眉梢	xi shang mei shao
如鱼得水	ru yu de shui
不惜代价	bu xi dai jia
悲痛欲绝	bei tong yu jue
渐入佳境	jian ru jia jing
求同存异	qiu tong cun yi
敢做敢为	gan zuo gan wei
励精图治	li jing tu zhi
作贼心虚	zuo zei xin xu
钩心斗角	gou xin dou jiao
光彩夺目	guang cai duo mu
大庭广众	da ting guang zhong
各行其是	ge xing qi shi
深恶痛恨	shen wu tong hen
嘻皮笑脸	xi pi xiao lian
高官厚禄	gao guan hou lu
留恋不舍	liu lian bu she
可想而知	ke xiang er zhi
宽大为怀	kuan da wei huai
艰难险阻	jian nan xian zu
一吐为快	yi tu wei kuai
大海捞针	da hai lao zhen
与世无争	yu shi wu zheng
阴谋诡计	yin mou gui ji
过眼云烟	guo yan yun yan
赴汤蹈火	fu tang dao huo
现身说法	xian shen shuo fa
神秘莫测	shen mi mo ce
说到做到	shuo dao zuo dao
喜怒无常	xi nu wu chang
赏罚分明	shang fa fen ming
胸有成竹	xiong you cheng zhu
白驹过隙	bai ju guo xi
不速之客	bu su zhi ke
临危受命	lin wei shou ming
山高水远	shan gao shui yuan
牵肠挂肚	qian chang gua du
自立门户	zi li men hu
缘木求鱼	yuan mu qiu yu
马到功成	ma dao gong cheng
蒙昧无知	meng mei wu zhi
来者不拒	lai zhe bu ju
记忆犹新	ji yi you xin
出头露面	chu tou lu mian
悠然自得	you ran zi de
伤筋动骨	shang jin dong gu
丰富多彩	feng fu duo cai
留有余地	liu you yu di
瘦骨如柴	shou gu ru chai
下笔成章	xia bi cheng zhang
驰名中外	chi ming zhong wai
老调重谈	lao diao chong tan
绚丽多彩	xuan li duo cai
死皮赖脸	si pi lai lian
千方百计	qian fang bai ji
寄人篱下	ji ren li xia
不能自已	bu neng zi yi
春华秋实	chun hua qiu shi
天真无邪	tian zhen wu xie
念念不忘	nian nian bu wang
独辟蹊径	du pi xi jing
天衣无缝	tian yi wu feng
沉不住气	chen bu zhu qi
新来乍到	xin lai zha dao
择善而从	ze shan er cong
多愁善感	duo chou shan gan
自讨苦吃	zi tao ku chi
高枕无忧	gao zhen wu you
冷酷无情	leng ku wu qing
变幻莫测	bian huan mo ce
甘拜下风	gan bai xia feng
养虎为患	yang hu wei huan
惘然若失	wang ran ruo shi
怨声载道	yuan sheng zai dao
锦上添花	jin shang tian hua
十面埋伏	shi mian mai fu
流落他乡	liu luo ta xiang
合情合理	he qing he li
天方夜谭	tian fang ye tan
物以类聚	wu yi lei ju
自食其言	zi shi qi yan
小巧玲珑	xiao qiao ling long
天各一方	tian ge yi fang
平心而论	ping xin er lun
一扫而光	yi sao er guang
慌手慌脚	huang shou huang jiao
素不相识	su bu xiang shi
待人接物	dai ren jie wu
志大才疏	zhi da cai shu
筋疲力竭	jin pi li jie
意想不到	yi xiang bu dao
电闪雷鸣	dian shan lei ming
打成一片	da cheng yi pian
引人入胜	yin ren ru sheng
心服口服	xin fu kou fu
花天酒地	hua tian jiu di
没完没了	mei wan mei liao
慢条斯理	man tiao si li
狐群狗党	hu qun gou dang
任人唯贤	ren ren wei xian
大摇大摆	da yao da bai
追根求源	zhui gen qiu yuan
拍案叫绝	pai an jiao jue
扬长避短	yang chang bi duan
瓮中捉鳖	weng zhong zhuo bie
娓娓动听	wei wei dong ting
镇定自若	zhen ding zi ruo
是非不分	shi fei bu fen
默默无声	mo mo wu sheng
寸草不生	cun cao bu sheng
坐失时机	zuo shi shi ji
回味无穷	hui wei wu qiong
不辞劳苦	bu ci lao ku
横行霸道	heng xing ba dao
无法无天	wu fa wu tian
拉帮结派	la bang jie pai
盛情难却	sheng qing nan que
公平合理	gong ping he li
息息相关	xi xi xiang guan
泰然处之	tai ran chu zhi
志同道合	zhi tong dao he
魂飞天外	hun fei tian wai
如出一辙	ru chu yi zhe
小人得志	xiao ren de zhi
大惑不解	da huo bu jie
临危不乱	lin wei bu luan
庸人自扰	yong ren zi rao
心宽体胖	xin kuan ti pan
能者为师	neng zhe wei shi
移花接木	yi hua jie mu
汗如雨下	han ru yu xia
功成身退	gong cheng shen tui
诗情画意	shi qing hua yi
遍地开花	bian di kai hua
故伎重演	gu ji zhong yan
聚精凝神	ju jing ning shen
臭名昭著	chou ming zhao zhu
忠心耿耿	zhong xin geng geng
字正腔圆	zi zheng qiang yuan
谈何容易	tan he rong yi
铺张浪费	pu zhang lang fei
大跌眼镜	da die yan jing
真情实感	zhen qing shi gan
风声鹤唳	feng sheng he li
包罗万象	bao luo wan xiang
惨不忍睹	can bu ren du
稀奇古怪	xi qi gu guai
意料之外	yi liao zhi wai
甜言蜜语	tian yan mi yu
坚如磐石	jian ru pan shi
分毫不差	fen hao bu cha
马不停蹄	ma bu ting ti
大浪淘沙	da lang tao sha
周而复始	zhou er fu shi
痛哭流涕	tong ku liu ti
对答如流	dui da ru liu
怒容满面	nu rong man mian
严严实实	yan yan shi shi
千真万确	qian zhen wan que
声东击西	sheng dong ji xi
日久天长	ri jiu tian chang
若即若离	ruo ji ruo li
模棱两可	mo leng liang ke
僧多粥少	seng duo zhou shao
镜花水月	jing hua shui yue
闭目塞听	bi mu se ting
痛改前非	tong gai qian fei
相形见绌	xiang xing jian chu
无所不有	wu suo bu you
每况愈下	mei kuang yu xia
无关痛痒	wu guan tong yang
博闻强记	bo wen qiang ji
回心转意	hui xin zhuan yi
如履平地	ru lu ping di
迫在眉睫	po zai mei jie
衣冠禽兽	yi guan qin shou
慷慨激昂	kang kai ji ang
连锁反应	lian suo fan ying
不失时机	bu shi shi ji
天道酬勤	tian dao chou qin
垂手可得	chui shou ke de
口耳相传	kou er xiang chuan
勃然大怒	bo ran da nu
国破家亡	guo po jia wang
气急败坏	qi ji bai huai
同流合污	tong liu he wu
争奇斗艳	zheng qi dou yan
日新月异	ri xin yue yi
未雨绸缪	wei yu chou mou
无所作为	wu suo zuo wei
意气用事	yi qi yong shi
一飞冲天	yi fei chong tian
苦思冥想	ku si ming xiang
不拘一格	bu ju yi ge
虎口拔牙	hu kou ba ya
家家户户	jia jia hu hu
飞禽走兽	fei qin zou shou
龙飞凤舞	long fei feng wu
浩如烟海	hao ru yan hai
地覆天翻	di fu tian fan
敬而远之	jing er yuan zhi
扶危济困	fu wei ji kun
悄然无声	qiao ran wu sheng
克勤克俭	ke qin ke jian
厚积薄发	hou ji bo fa
费尽心机	fei jin xin ji
治病救人	zhi bing jiu ren
乱七八糟	luan qi ba zao
相辅相成	xiang fu xiang cheng
光明大道	guang ming da dao
百密一疏	bai mi yi shu
参差不齐	cen ci bu qi
由衷之言	you zhong zhi yan
以备万一	yi bei wan yi
打破陈规	da po chen gui
大功告成	da gong gao cheng
令人钦佩	ling ren qin pei
公而忘私	gong er wang si
大言不惭	da yan bu can
以己度人	yi ji duo ren
刻苦钻研	ke ku zuan yan
唯利是图	wei li shi tu
离乡背井	li xiang bei jing
挤眉弄眼	ji mei nong yan
如坐针毡	ru zuo zhen zhan
所向无敌	suo xiang wu di
惨无人道	can wu ren dao
铺天盖地	pu tian gai di
迎刃而解	ying ren er jie
寥寥无几	liao liao wu ji
一潭死水	yi tan si shui
节衣缩食	jie yi suo shi
一语双关	yi yu shuang guan
动如脱兔	dong ru tuo tu
混淆视听	hun xiao shi ting
力争上游	li zheng shang you
奇思妙想	qi si miao xiang
步调一致	bu diao yi zhi
瞒上欺下	man shang qi xia
一钱不值	yi qian bu zhi
大开眼界	da kai yan jie
推己及人	tui ji ji ren
不分伯仲	bu fen bo zhong
平起平坐	ping qi ping zuo
感人至深	gan ren zhi shen
来之不易	lai zhi bu yi
嫁祸于人	jia huo yu ren
情深意重	qing shen yi zhong
腾空而起	teng kong er qi
小心谨慎	xiao xin jin shen
通宵达旦	tong xiao da dan
千锤百炼	qian chui bai lian
管中窥豹	guan zhong kui bao
没齿难忘	mo chi nan wang
人微言轻	ren wei yan qing
一反常态	yi fan chang tai
省吃俭用	sheng chi jian yong
玲珑剔透	ling long ti tou
自顾不暇	zi gu bu xia
一动不动	yi dong bu dong
大显身手	da xian shen shou
前无古人	qian wu gu ren
干净利落	gan jing li luo
另眼相待	ling yan xiang dai
好高骛远	hao gao wu yuan
抱薪救火	bao xin jiu huo
握手言欢	wo shou yan huan
百折不挠	bai zhe bu nao
天下为公	tian xia wei gong
不知所云	bu zhi suo yun
直接了当	zhi jie liao dang
回头是岸	hui tou shi an
断章取义	duan zhang qu yi
脍炙人口	kuai zhi ren kou
攻其不备	gong qi bu bei
心如死灰	xin ru si hui
深思熟虑	shen si shu lu
老调重弹	lao diao zhong dan
礼尚往来	li shang wang lai
左邻右舍	zuo lin you she
行色匆匆	xing se cong cong
玩世不恭	wan shi bu gong
黔驴技穷	qian lu ji qiong
天灾人祸	tian zai ren huo
当家作主	dang jia zuo zhu
不知所措	bu zhi suo cuo
得意扬扬	de yi yang yang
笔走龙蛇	bi zou long she
桃红柳绿	tao hong liu lu
熟门熟路	shu men shu lu
一鼓作气	yi gu zuo qi
轩然大波	xuan ran da bo
熟能生巧	shu neng sheng qiao
化敌为友	hua di wei you
天长日久	tian chang ri jiu
两厢情愿	liang xiang qing yuan
令人瞩目	ling ren zhu mu
绳之以法	sheng zhi yi fa
弃旧图新	qi jiu tu xin
追名逐利	zhui ming zhu li
并肩作战	bing jian zuo zhan
无懈可击	wu xie ke ji
明争暗斗	ming zheng an dou
柔能克刚	rou neng ke gang
杀鸡吓猴	sha ji xia hou
手足之情	shou zu zhi qing
忍痛割爱	ren tong ge ai
借题发挥	jie ti fa hui
冲锋陷阵	chong feng xian zhen
阴阳怪气	yin yang guai qi
摩拳擦掌	mo quan ca zhang
不谋而合	bu mou er he
贪生怕死	tan sheng pa si
七嘴八舌	qi zui ba she
步步为营	bu bu wei ying
凿壁偷光	zao bi tou guang
引人瞩目	yin ren zhu mu
天外有天	tian wai you tian
登峰造极	deng feng zao ji
齐头并进	qi tou bing jin
一劳永逸	yi lao yong yi
见异思迁	jian yi si qian
称王称霸	cheng wang cheng ba
熠熠生辉	yi yi sheng hui
万般无奈	wan ban wu nai
颠沛流离	dian pei liu li
蒙混过关	meng hun guo guan
弄虚作假	nong xu zuo jia
妙不可言	miao bu ke yan
颠倒黑白	dian dao hei bai
万紫千红	wan zi qian hong
天朗气清	tian lang qi qing
古今中外	gu jin zhong wai
勃然大怒	bo ran da nu
如虎添翼	ru hu tian yi
相形见绌	xiang xing jian chu
惶惶不安	huang huang bu an
不以为然	bu yi wei ran
招架不住	zhao jia bu zhu
落叶知秋	luo ye zhi qiu
为虎作伥	wei hu zuo chang
一语道破	yi yu dao po
面面俱到	mian mian ju dao
千载难逢	qian zai nan feng
添砖加瓦	tian zhuan jie wa
有色眼镜	you se yan jing
崭露头角	zhan lu tou jiao
匪夷所思	fei yi suo si
螳臂挡车	tang bi dang che
改弦易辙	gai xian yi zhe
众星捧月	zhong xing peng yue
一如既往	yi ru ji wang
精打细算	jing da xi suan
喜怒哀乐	xi nu ai le
本末倒置	ben mo dao zhi
一步登天	yi bu deng tian
失道寡助	shi dao gua zhu
痛改前非	tong gai qian fei
不足为据	bu zu wei ju
千真万确	qian zhen wan que
超群绝伦	chao qun jue lun
漫不经心	man bu jing xin
隐恶扬善	yin e yang shan
独当一面	du dang yi mian
学海无涯	xue hai wu ya
多如牛毛	duo ru niu mao
通风报信	tong feng bao xin
急流勇进	ji liu yong jin
学富五车	xue fu wu che
真心实意	zhen xin shi yi
奄奄一息	yan yan yi xi
画蛇添足	hua she tian zu
不识时务	bu shi shi wu
一刻千金	yi ke qian jin
一日千里	yi ri qian li
暗度陈仓	an du chen cang
来日方长	lai ri fang chang
十年寒窗	shi nian han chuang
一无所得	yi wu suo de
无济于事	wu ji yu shi
破釜沉舟	po fu chen zhou
临危不惧	lin wei bu ju
摇尾乞怜	yao wei qi lian
一诺千金	yi nuo qian jin
初露锋芒	chu lu feng mang
默默无闻	mo mo wu wen
胡编乱造	hu bian luan zao
六亲不认	liu qin bu ren
含情脉脉	han qing mo mo
不惜一切	bu xi yi qie
白头偕老	bai tou xie lao
无影无踪	wu ying wu zong
若有所思	ruo you suo si
闲言碎语	xian yan sui yu
死心塌地	si xin ta di
勤能补拙	qin neng bu zhuo
一触即发	yi chu ji fa
百花齐放	bai hua qi fang
求知若渴	qiu zhi ruo ke
一团漆黑	yi tuan qi hei
凿壁借光	zao bi jie guang
生死关头	sheng si guan tou
谨言慎行	jin yan shen xing
功德圆满	gong de yuan man
无可比拟	wu ke bi ni
锋芒毕露	feng mang bi lu
二话没说	er hua mei shuo
舍本求末	she ben qiu mo
珠联璧合	zhu lian bi he
不瘟不火	bu wen bu huo
大手大脚	da shou da jiao
沧海一粟	cang hai yi su
心有余悸	xin you yu ji
江山如画	jiang shan ru hua
大智若愚	da zhi ruo yu
起早贪黑	qi zao tan hei
草木皆兵	cao mu jie bing
各自为政	ge zi wei zheng
走为上计	zou wei shang ji
面如土色	mian ru tu se
久经风霜	jiu jing feng shuang
风行一时	feng xing yi shi
逃之夭夭	tao zhi yao yao
谈笑风生	tan xiao feng sheng
正人君子	zheng ren jun zi
双管齐下	shuang guan qi xia
逐字逐句	zhu zi zhu ju
取之不尽	qu zhi bu jin
七上八下	qi shang ba xia
各有利弊	ge you li bi
憨态可掬	han tai ke ju
深谋远虑	shen mou yuan lu
凭空捏造	ping kong nie zao
假仁假义	jia ren jia yi
指手划脚	zhi shou hua jiao
急不可待	ji bu ke dai
蔚为大观	wei wei da guan
略见一斑	lue jian yi ban
风雨飘摇	feng yu piao yao
前功尽弃	qian gong jin qi
得意洋洋	de yi yang yang
拙嘴笨舌	zhuo zui ben she
炉火纯青	lu huo chun qing
指日可待	zhi ri ke dai
天长地久	tian chang di jiu
贯彻始终	guan che shi zhong
猪朋狗友	zhu peng gou you
千言万语	qian yan wan yu
天网恢恢	tian wang hui hui
天南海北	tian nan hai bei
人面兽心	ren mian shou xin
高高在上	gao gao zai shang
虎头蛇尾	hu tou she wei
休戚相关	xiu qi xiang guan
方兴未艾	fang xing wei ai
势不可当	shi bu ke dang
冷暖自知	leng nuan zi zhi
猪狗不如	zhu gou bu ru
现身说法	xian shen shuo fa
思绪万千	si xu wan qian
相映成趣	xiang ying cheng qu
似懂非懂	si dong fei dong
独当一面	du dang yi mian
浅尝辄止	qian chang zhe zhi
归根到底	gui gen dao di
争分夺秒	zheng fen duo miao
望眼欲穿	wang yan yu chuan
举不胜举	ju bu sheng ju
平易近人	ping yi jin ren
点睛之笔	dian jing zhi bi
通力合作	tong li he zuo
忧心忡忡	you xin chong chong
宾朋满座	bin peng man zuo
海市蜃楼	hai shi shen lou
集腋成裘	ji ye cheng qiu
逢凶化吉	feng xiong hua ji
颠扑不破	dian pu bu po
名垂千古	ming chui qian gu
推而广之	tui er guang zhi
前所未闻	qian suo wei wen
入不敷出	ru bu fu chu
完美无缺	wan mei wu que
成人之美	cheng ren zhi mei
大惊失色	da jing shi se
发号施令	fa hao shi ling
鸡飞狗跳	ji fei gou tiao
寻根问底	xun gen wen di
一鸣惊人	yi ming jing ren
神采飞扬	shen cai fei yang
供不应求	gong bu ying qiu
相见恨晚	xiang jian hen wan
一哄而散	yi hong er san
荡然无存	dang ran wu cun
重归于好	chong gui yu hao
落叶归根	luo ye gui gen
千人一面	qian ren yi mian
以毒攻毒	yi du gong du
利令智昏	li ling zhi hun
惹事生非	re shi sheng fei
笼中之鸟	long zhong zhi niao
娇生惯养	jiao sheng guan yang
如饥如渴	ru ji ru ke
坚贞不渝	jian zhen bu yu
自圆其说	zi yuan qi shuo
寸步难行	cun bu nan xing
煽风点火	shan feng dian huo
积劳成病	ji lao cheng bing
开门见山	kai men jian shan
一面之缘	yi mian zhi yuan
弹尽粮绝	dan jin liang jue
狼窝虎穴	lang wo hu xue
壮志凌云	zhuang zhi ling yun
暴跳如雷	bao tiao ru lei
一叶障目	yi ye zhang mu
头重脚轻	tou zhong jiao qing
众望所归	zhong wang suo gui
明哲保身	ming zhe bao shen
裹足不前	guo zu bu qian
落荒而走	luo huang er zou
见风是雨	jian feng shi yu
一心一意	yi xin yi yi
背水一战	bei shui yi zhan
春意盎然	chun yi ang ran
流言蜚语	liu yan fei yu
酒肉朋友	jiu rou peng you
络绎不绝	luo yi bu jue
善始善终	shan shi shan zhong
众口难调	zhong kou nan tiao
饱经沧桑	bao jing cang sang
顺藤摸瓜	shun teng mo gua
防不胜防	fang bu sheng fang
万众一心	wan zhong yi xin
不虚此行	bu xu ci xing
自食其力	zi shi qi li
人山人海	ren shan ren hai
欢声雷动	huan sheng lei dong
晕头转向	yun tou zhuan xiang
雄心壮志	xiong xin zhuang zhi
紧要关头	jin yao guan tou
水到渠成	shui dao qu cheng
星星之火	xing xing zhi huo
水落石出	shui luo shi chu
空口无凭	kong kou wu ping
一脉相传	yi mai xiang chuan
兢兢业业	jing jing ye ye
运用自如	yun yong zi ru
铁案如山	tie an ru shan
言之有物	yan zhi you wu
有根有据	you gen you ju
义正辞严	yi zheng ci yan
疏忽大意	shu hu da yi
堆积如山	dui ji ru shan
怅然若失	chang ran ruo shi
独具匠心	du ju jiang xin
天经地义	tian jing di yi
劫后余生	jie hou yu sheng
不可胜数	bu ke sheng shu
劈头盖脸	pi tou gai lian
一波三折	yi bo san zhe
街头巷尾	jie tou xiang wei
天壤之隔	tian rang zhi ge
千山万水	qian shan wan shui
朝秦暮楚	zhao qin mu chu
风餐露宿	feng can lu su
事倍功半	shi bei gong ban
瞠目结舌	cheng mu jie she
公私兼顾	gong si jian gu
前思后想	qian si hou xiang
敏而好学	min er hao xue
青梅竹马	qing mei zhu ma
有勇有谋	you yong you mou
天外有天	tian wai you tian
窃窃私议	qie qie si yi
海底捞针	hai di lao zhen
不可告人	bu ke gao ren
毋庸置疑	wu yong zhi yi
急不择言	ji bu ze yan
默默无言	mo mo wu yan
谈笑自若	tan xiao zi ruo
亭亭玉立	ting ting yu li
莫逆之交	mo ni zhi jiao
瓜熟蒂落	gua shu di luo
命中注定	ming zhong zhu ding
浮光掠影	fu guang lue ying
炙手可热	zhi shou ke re
弱肉强食	ruo rou qiang shi
人才济济	ren cai ji ji
独具一格	du ju yi ge
同心合力	tong xin he li
铿锵有力	keng qiang you li
爱不释手	ai bu shi shou
心满意足	xin man yi zu
从长计议	cong chang ji yi
天造地设	tian zao di she
不仁不义	bu ren bu yi
五洲四海	wu zhou si hai
动辄得咎	dong zhe de jiu
大起大落	da qi da luo
草草了事	cao cao liao shi
相依为命	xiang yi wei ming
无人问津	wu ren wen jin
万人空巷	wan ren kong xiang
下落不明	xia luo bu ming
真情实意	zhen qing shi yi
绚丽多姿	xuan li duo zi
风流人物	feng liu ren wu
临渴掘井	lin ke jue jing
徘徊不前	pai huai bu qian
有条有理	you tiao you li
安如磐石	an ru pan shi
推三阻四	tui san zu si
天南地北	tian nan di bei
物尽其用	wu jin qi yong
舍生忘死	she sheng wang si
冷若冰霜	leng ruo bing shuang
黑灯瞎火	hei deng xia huo
日月如梭	ri yue ru suo
身临其境	shen lin qi jing
打抱不平	da bao bu ping
动如脱兔	dong ru tuo tu
豪言壮语	hao yan zhuang yu
哄堂大笑	hong tang da xiao
不请自来	bu qing zi lai
大失所望	da shi suo wang
胡作非为	hu zuo fei wei
明察暗访	ming cha an fang
川流不息	chuan liu bu xi
狗急跳墙	gou ji tiao qiang
触目惊心	chu mu jing xin
整装待发	zheng zhuang dai fa
为期不远	wei qi bu yuan
云开日出	yun kai ri chu
举目无亲	ju mu wu qin
劳民伤财	lao min shang cai
大千世界	da qian shi jie
摇头摆尾	yao tou bai wei
不知不觉	bu zhi bu jue
笑里藏刀	xiao li cang dao
安份守己	an fen shou ji
大动干戈	da dong gan ge
语无伦次	yu wu lun ci
孜孜不倦	zi zi bu juan
桀骜不驯	jie ao bu xun
男女老少	nan nu lao shao
童心未泯	tong xin wei min
祸在旦夕	huo zai dan xi
不打自招	bu da zi zhao
火冒三丈	huo mao san zhang
四平八稳	si ping ba wen
走马观花	zou ma guan hua
畅所欲言	chang suo yu yan
出类拔萃	chu lei ba cui
出生入死	chu sheng ru si
踟蹰不前	chi chu bu qian
夸父追日	kua fu zhui ri
井井有条	jing jing you tiao
不容分说	bu rong fen shuo
兴趣盎然	xing qu ang ran
辗转反侧	zhan zhuan fan ce
穷奢极欲	qiong she ji yu
世外桃源	shi wai tao yuan
英姿焕发	ying zi huan fa
何乐不为	he le bu wei
余味无穷	yu wei wu qiong
一扫而空	yi sao er kong
茫然失措	mang ran shi cuo
各奔前程	ge ben qian cheng
滚瓜烂熟	gun gua lan shu
千载难逢	qian zai nan feng
翻山越岭	fan shan yue ling
流言飞语	liu yan fei yu
大难临头	da nan lin tou
过意不去	guo yi bu qu
泥沙俱下	ni sha ju xia
三人成虎	san ren cheng hu
议论纷纷	yi lun fen fen
山穷水尽	shan qiong shui jin
铁杵成针	tie chu cheng zhen
腹背受敌	fu bei shou di
令人满意	ling ren man yi
大煞风景	da sha feng jing
众口一词	zhong kou yi ci
一举成名	yi ju cheng ming
荣华富贵	rong hua fu gui
积劳成疾	ji lao cheng ji
心口如一	xin kou ru yi
游刃有余	you ren you yu
覆水难收	fu shui nan shou
逆水行舟	ni shui xing zhou
为人师表	wei ren shi biao
以勤补拙	yi qin bu zhuo
天长日久	tian chang ri jiu
避实就虚	bi shi jiu xu
全盘托出	quan pan tuo chu
鞭长莫及	bian chang mo ji
良辰吉日	liang chen ji ri
多多益善	duo duo yi shan
傲慢无礼	ao man wu li
作壁上观	zuo bi shang guan
心胸狭隘	xin xiong xia ai
咫尺天涯	zhi chi tian ya
鱼龙混杂	yu long hun za
比翼齐飞	bi yi qi fei
天涯海角	tian ya hai jiao
有棱有角	you leng you jiao
摩肩擦踵	mo jian ca zhong
心无旁骛	xin wu pang wu
初来乍到	chu lai zha dao
风起云涌	feng qi yun yong
穷追不舍	qiong zhui bu she
勇猛果敢	yong meng guo gan
千辛万苦	qian xin wan ku
谈古论今	tan gu lun jin
一张一弛	yi zhang yi chi
如胶似漆	ru jiao si qi
气宇轩昂	qi yu xuan ang
扶摇直上	fu yao zhi shang
不伦不类	bu lun bu lei
史无前例	shi wu qian li
鸿运当头	hong yun dang tou
疾风暴雨	ji feng bao yu
心腹大患	xin fu da huan
独占鳌头	du zhan ao tou
有血有肉	you xue you rou
自暴自弃	zi bao zi qi
少年老成	shao nian lao cheng
各显神通	ge xian shen tong
四面楚歌	si mian chu ge
独具一格	du ju yi ge
捉摸不定	zhuo mo bu ding
整齐划一	zheng qi hua yi
知彼知己	zhi bi zhi ji
沉鱼落雁	chen yu luo yan
山崩地裂	shan beng di lie
刻苦耐劳	ke ku nai lao
将计就计	jiang ji jiu ji
置身事外	zhi shen shi wai
永垂青史	yong chui qing shi
做贼心虚	zuo zei xin xu
坚持不渝	jian chi bu yu
势不两立	shi bu liang li
大才小用	da cai xiao yong
分道扬镳	fen dao yang biao
生气勃勃	sheng qi bo bo
眉飞色舞	mei fei se wu
承前启后	cheng qian qi hou
权衡利弊	quan heng li bi
不顾一切	bu gu yi qie
以一当十	yi yi dang shi
手疾眼快	shou ji yan kuai
千疮百孔	qian chuang bai kong
随机应变	sui ji ying bian
略逊一筹	lue xun yi chou
五谷丰登	wu gu feng deng
百年大计	bai nian da ji
相视而笑	xiang shi er xiao
为所欲为	wei suo yu wei
地广人稀	di guang ren xi
悲欢离合	bei huan li he
生动活泼	sheng dong huo po
因噎废食	yin ye fei shi
孤陋寡闻	gu lou gua wen
一举两得	yi ju liang de
欢呼鼓舞	huan hu gu wu
流芳百世	liu fang bai shi
跳梁小丑	tiao liang xiao chou
岂有此理	qi you ci li
洞察秋毫	dong cha qiu hao
口诛笔伐	kou zhu bi fa
含苞欲放	han bao yu fang
略知一二	lue zhi yi er
望穿秋水	wang chuan qiu shui
心猿意马	xin yuan yi ma
身经百战	shen jing bai zhan
接连不断	jie lian bu duan
路不拾遗	lu bu shi yi
满怀信心	man huai xin xin
兔死狐悲	tu si hu bei
杀鸡儆猴	sha ji jing hou
夸夸其谈	kua kua qi tan
闻所未闻	wen suo wei wen
理所当然	li suo dang ran
恩威并重	en wei bing zhong
天壤之别	tian rang zhi bie
打破常规	da po chang gui
傲然屹立	ao ran yi li
由表及里	you biao ji li
心口不一	xin kou bu yi
貌不惊人	mao bu jing ren
前俯后仰	qian fu hou yang
屏气凝神	bing qi ning shen
知法犯法	zhi fa fan fa
心甘情愿	xin gan qing yuan
短兵相接	duan bing xiang jie
九霄云外	jiu xiao yun wai
斗志昂扬	dou zhi ang yang
怒目而视	nu mu er shi
心领神会	xin ling shen hui
前车之鉴	qian che zhi jian
画龙点睛	hua long dian jing
博大精深	bo da jing shen
德高望重	de gao wang zhong
狭路相逢	xia lu xiang feng
瓮中之鳖	weng zhong zhi bie
加油添醋	jia you tian cu
举重若轻	ju zhong ruo qing
津津乐道	jin jin le dao
心有灵犀	xin you ling xi
头头是道	tou tou shi dao
有求必应	you qiu bi ying
徒有虚名	tu you xu ming
变化莫测	bian hua mo ce
欢声笑语	huan sheng xiao yu
捷足先登	jie zu xian deng
彻头彻尾	che tou che wei
得过且过	de guo qie guo
面目全非	mian mu quan fei
泛泛而谈	fan fan er tan
蛇蝎心肠	she xie xin chang
听之任之	ting zhi ren zhi
天衣无缝	tian yi wu feng
归心似箭	gui xin si jian
矢志不移	shi zhi bu yi
刮目相看	gua mu xiang kan
嗤之以鼻	chi zhi yi bi
渔翁得利	yu weng de li
蹑手蹑脚	nie shou nie jiao
宽宏大度	kuan hong da du
后会有期	hou hui you qi
插翅难飞	cha chi nan fei
天昏地暗	tian hun di an
有恃无恐	you shi wu kong
雪上加霜	xue shang jia shuang
前程似锦	qian cheng si jin
浅显易懂	qian xian yi dong
水性杨花	shui xing yang hua
花言巧语	hua yan qiao yu
成竹在胸	cheng zhu zai xiong
辞简意赅	ci jian yi gai
琳琅满目	lin lang man mu
稳操胜券	wen cao sheng quan
差强人意	cha qiang ren yi
如痴如醉	ru chi ru zui
玲珑剔透	ling long ti tou
深入浅出	shen ru qian chu
稳如磐石	wen ru pan shi
郑重其事	zheng zhong qi shi
思前想后	si qian xiang hou
不修边幅	bu xiu bian fu
一无所有	yi wu suo you
劫后余生	jie hou yu sheng
魂牵梦萦	hun qian meng ying
竭泽而渔	jie ze er yu
高傲自大	gao ao zi da
虚张声势	xu zhang sheng shi
豆蔻年华	dou kou nian hua
恶语中伤	e yu zhong shang
有利可图	you li ke tu
变化无穷	bian hua wu qiong
白日做梦	bai ri zuo meng
矢口否认	shi kou fou ren
瓜熟蒂落	gua shu di luo
天高地厚	tian gao di hou
心事重重	xin shi chong chong
急不可耐	ji bu ke nai
雾里看花	wu li kan hua
勤能补拙	qin neng bu zhuo
高瞻远瞩	gao zhan yuan zhu
一本万利	yi ben wan li
火上加油	huo shang jia you
长驱直入	chang qu zhi ru
浓妆艳抹	nong zhuang yan mo
浮想联翩	fu xiang lian pian
巧言令色	qiao yan ling se
十有八九	shi you ba jiu
寸步难移	cun bu nan yi
灰飞烟灭	hui fei yan mie
滥竽充数	lan yu chong shu
洋洋得意	yang yang de yi
奋发图强	fen fa tu qiang
气味相投	qi wei xiang tou
悲喜交加	bei xi jiao jia
一纸空文	yi zhi kong wen
气势汹汹	qi shi xiong xiong
挨家挨户	ai jia ai hu
建功立业	jian gong li ye
量力而行	liang li er xing
公报私仇	gong bao si chou
养精蓄锐	yang jing xu rui
千家万户	qian jia wan hu
唇齿相依	chun chi xiang yi
五彩斑斓	wu cai ban lan
舍己救人	she ji jiu ren
乔装打扮	qiao zhuang da ban
人心所向	ren xin suo xiang
捶胸顿足	chui xiong dun zu
载歌载舞	zai ge zai wu
多种多样	duo zhong duo yang
龙蟠虎踞	long pan hu ju
疏而不漏	shu er bu lou
哑然失笑	ya ran shi xiao
笼络人心	long luo ren xin
相知恨晚	xiang zhi hen wan
目光短浅	mu guang duan qian
结党营私	jie dang ying si
狂风暴雨	kuang feng bao yu
异曲同工	yi qu tong gong
为非作歹	wei fei zuo dai
黄雀在后	huang que zai hou
不偏不倚	bu pian bu yi
字斟句酌	zi zhen ju zhuo
因势利导	yin shi li dao
铁树开花	tie shu kai hua
得心应手	de xin ying shou
格格不入	ge ge bu ru
渺无音信	miao wu yin xin
勤学好问	qin xue hao wen
夺眶而出	duo kuang er chu
狡兔三窟	jiao tu san ku
拒之门外	ju zhi men wai
不近人情	bu jin ren qing
大相径庭	da xiang jing ting
曲高和寡	qu gao he gua
深不可测	shen bu ke ce
不怀好意	bu huai hao yi
一穷二白	yi qiong er bai
狂风怒号	kuang feng nu hao
无可厚非	wu ke hou fei
内忧外患	nei you wai huan
大煞风景	da sha feng jing
欢天喜地	huan tian xi di
脚踏实地	jiao ta shi di
和睦相处	he mu xiang chu
爱屋及乌	ai wu ji wu
励精图治	li jing tu zhi
一望无际	yi wang wu ji
画饼充饥	hua bing chong ji
由浅入深	you qian ru shen
死气沉沉	si qi chen chen
欢聚一堂	huan ju yi tang
竭尽全力	jie jin quan li
有增无减	you zeng wu jian
了若指掌	liao ruo zhi zhang
后来居上	hou lai ju shang
评头论足	ping tou lun zu
永垂不朽	yong chui bu xiu
后顾之忧	hou gu zhi you
举一反三	ju yi fan san
营私舞弊	ying si wu bi
慷慨仗义	kang kai zhang yi
龙争虎斗	long zheng hu dou
声嘶力竭	sheng si li jie
肺腑之言	fei fu zhi yan
适者生存	shi zhe sheng cun
另起炉灶	ling qi lu zao
受宠若惊	shou chong ruo jing
浑浑噩噩	hun hun e e
豁然省悟	huo ran xing wu
走投无路	zou tou wu lu
事不关己	shi bu guan ji
力挽狂澜	li wan kuang lan
无所顾忌	wu suo gu ji
冷言冷语	leng yan leng yu
大雨滂沱	da yu pang tuo
不辱使命	bu ru shi ming
坐无虚席	zuo wu xu xi
欲速不达	yu su bu da
欢呼雷动	huan hu lei dong
劳师动众	lao shi dong zhong
良药苦口	liang yao ku kou
座无虚席	zuo wu xu xi
斤斤计较	jin jin ji jiao
家破人亡	jia po ren wang
萎靡不振	wei mi bu zhen
一分为二	yi fen wei er
大名鼎鼎	da ming ding ding
到处碰壁	dao chu peng bi
一决雌雄	yi jue ci xiong
探头探脑	tan tou tan nao)
旷日持久	kuang ri chi jiu
一错再错	yi cuo zai cuo
耳目一新	er mu yi xin
安然无事	an ran wu shi
无稽之谈	wu ji zhi tan
千军万马	qian jun wan ma
众目共睹	zhong mu gong du
罪魁祸首	zui kui huo shou
白纸黑字	bai zhi hei zi
平白无故	ping bai wu gu
不即不离	bu ji bu li
熙熙攘攘	xi xi rang rang
丢盔弃甲	diu kui qi jia
骨鲠在喉	gu geng zai hou
画地为牢	hua di wei lao
云淡风轻	yun dan feng qing
匹夫有责	pi fu you ze
才华横溢	cai hua heng yi
横眉竖目	heng mei shu mu
力所能及	li suo neng ji
以强凌弱	yi qiang ling ruo
步履蹒跚	bu lu pan shan
原形毕露	yuan xing bi lu
手下留情	shou xia liu qing
急功近利	ji gong jin li
赤手空拳	chi shou kong quan
勾心斗角	gou xin dou jiao
性命攸关	xing ming you guan
大公无私	da gong wu si
水乳交融	shui ru jiao rong
郁郁葱葱	yu yu cong cong
劈荆斩棘	pi jing zhan ji
专心一意	zhuan xin yi yi
钻牛角尖	zuan niu jiao jian
生死之交	sheng si zhi jiao
高出一筹	gao chu yi chou
看风使舵	kan feng shi duo
穷则思变	qiong ze si bian
喜新厌旧	xi xin yan jiu
约法三章	yue fa san zhang
偷天换日	tou tian huan ri
大难临头	da nan lin tou
善有善报	shan you shan bao
三头六臂	san tou liu bi
情非得已	qing fei de yi
八仙过海	ba xian guo hai
风调雨顺	feng tiao yu shun
错综复杂	cuo zong fu za
人杰地灵	ren jie di ling
直言不讳	zhi yan bu hui
中流砥柱	zhong liu di zhu
潜移默化	qian yi mo hua
骑虎难下	qi hu nan xia
自鸣得意	zi ming de yi
狐朋狗党	hu peng gou dang
囫囵吞枣	hu lun tun zao
是非颠倒	shi fei dian dao
大获全胜	da huo quan sheng
水火不容	shui huo bu rong
未尝不可	wei chang bu ke
井井有序	jing jing you xu
百折不屈	bai zhe bu qu
如此而已	ru ci er yi
借古喻今	jie gu yu jin
略胜一筹	lue sheng yi chou
耐人寻味	nai ren xun wei
徒劳无益	tu lao wu yi
信誓旦旦	xin shi dan dan
虚度光阴	xu du guang yin
爆跳如雷	bao tiao ru lei
东山再起	dong shan zai qi
仗义执言	zhang yi zhi yan
大发雷霆	da fa lei ting
争先恐后	zheng xian kong hou
左右两难	zuo you liang nan
理屈词穷	li qu ci qiong
艰难困苦	jian nan kun ku
不可偏废	bu ke pian fei
大吹大擂	da chui da lei
无地自容	wu di zi rong
羞愧难当	xiu kui nan dang
风华正茂	feng hua zheng mao
天昏地暗	tian hun di an
不合时宜	bu he shi yi
忍气吞声	ren qi tun sheng
化为泡影	hua wei pao ying
天马行空	tian ma xing kong
万古长青	wan gu chang qing
狂风暴雨	kuang feng bao yu
虎视眈眈	hu shi dan dan
判若两人	pan ruo liang ren
东倒西歪	dong dao xi wai
萍水相逢	ping shui xiang feng
过眼烟云	guo yan yan yun
患难与共	huan nan yu gong
不着边际	bu zhuo bian ji
神情自若	shen qing zi ruo
难如登天	nan ru deng tian
一清二楚	yi qing er chu
大海捞针	da hai lao zhen
蛮不讲理	man bu jiang li
各行其道	ge xing qi dao
高耸入云	gao song ru yun
大厦将倾	da sha jiang qing
病入膏肓	bing ru gao huang
至死不渝	zhi si bu yu
紧锣密鼓	jin luo mi gu
打草惊蛇	da cao jing she
一颦一笑	yi pin yi xiao
东奔西走	dong ben xi zou
走马看花	zou ma kan hua
矫揉造作	jiao rou zao zuo
鲜为人知	xian wei ren zhi
身不由己	shen bu you ji
轻车熟路	qing che shu lu
低声细语	di sheng xi yu
插翅难逃	cha chi nan tao
自讨没趣	zi tao mei qu
宁死不屈	ning si bu qu
垂涎三尺	chui xian san chi
对牛弹琴	dui niu tan qin
心神不定	xin shen bu ding
一塌糊涂	yi ta hu tu
独一无二	du yi wu er
移风易俗	yi feng yi su
含苞待放	han bao dai fang
蜻蜓点水	qing ting dian shui
落落大方	luo luo da fang
湖光山色	hu guang shan se
戛然而止	jia ran er zhi
好逸恶劳	hao yi wu lao
奇装异服	qi zhuang yi fu
误打误撞	wu da wu zhuang
出乎意外	chu hu yi wai
生死与共	sheng si yu gong
拐弯抹角	guai wan mo jiao
措手不及	cuo shou bu ji
理亏心虚	li kui xin xu
无所不能	wu suo bu neng
虎口余生	hu kou yu sheng
人生如梦	ren sheng ru meng
弄巧反拙	nong qiao fan zhuo
过街老鼠	guo jie lao shu
与虎添翼	yu hu tian yi
追悔莫及	zhui hui mo ji
鬼使神差	gui shi shen chai
打小算盘	da xiao suan pan
纸上谈兵	zhi shang tan bing
隐姓埋名	yin xing mai ming
不省人事	bu xing ren shi
踌躇满志	chou chu man zhi
鹊巢鸠占	que chao jiu zhan
别无选择	bie wu xuan ze
勤学好问	qin xue hao wen
不知所以	bu zhi suo yi
自找麻烦	zi zhao ma fan
胡言乱语	hu yan luan yu
超群出众	chao qun chu zhong
十全十美	shi quan shi mei
陈规陋习	chen gui lou xi
照猫画虎	zhao mao hua hu
空前绝后	kong qian jue hou
精明强干	jing ming qiang gan
悬崖峭壁	xuan ya qiao bi
痛不欲生	tong bu yu sheng
大吃一惊	da chi yi jing
怦然心动	peng ran xin dong
反戈一击	fan ge yi ji
见风使舵	jian feng shi duo
愁肠寸断	chou chang cun duan
十之八九	shi zhi ba jiu
兴师动众	xing shi dong zhong
装模作样	zhuang mo zuo yang
反躬自省	fan gong zi xing
至理名言	zhi li ming yan
千姿百态	qian zi bai tai
花样翻新	hua yang fan xin
寸土不让	cun tu bu rang
自强不息	zi qiang bu xi
口出不逊	kou chu bu xun
狐假虎威	hu jia hu wei
吃苦耐劳	chi ku nai lao
能言善辩	neng yan shan bian
战无不胜	zhan wu bu sheng
神态自若	shen tai zi ruo
固若金汤	gu ruo jin tang
残兵败将	can bing bai jiang
殊途同归	shu tu tong gui
量力而为	liang li er wei
独善其身	du shan qi shen
坐立不安	zuo li bu an
日进斗金	ri jin dou jin
背信负义	bei xin fu yi
不可救药	bu ke jiu yao
百家争鸣	bai jia zheng ming
有朝一日	you zhao yi ri
善解人意	shan jie ren yi
口口声声	kou kou sheng sheng
拨云见日	bo yun jian ri
生机勃勃	sheng ji bo bo
不落俗套	bu luo su tao
气吞山河	qi tun shan he
拔刀相助	ba dao xiang zhu
不可名状	bu ke ming zhuang
生气蓬勃	sheng qi bo bo
开山鼻祖	kai shan bi zu
约定俗成	yue ding su cheng
天下无敌	tian xia wu di
怀恨在心	huai hen zai xin
力不能支	li bu neng zhi
功败垂成	gong bai chui cheng
似曾相识	si ceng xiang shi
莫名其妙	mo ming qi miao
舍近求远	she jin qiu yuan
万水千山	wan shui qian shan
好好先生	hao hao xian sheng
大喜过望	da xi guo wang
一毛不拔	yi mao bu ba
有气无力	you qi wu li
见利忘义	jian li wang yi
动魄惊心	dong po jing xin
层峦叠嶂	ceng luan die zhang
生死关头	sheng si guan tou
怒发冲冠	nu fa chong guan
大浪淘沙	da lang tao sha
披星戴月	pi xing dai yue
各尽其责	ge jin qi ze
一本正经	yi ben zheng jing
闲情逸致	xian qing yi zhi
永无止境	yong wu zhi jing
异想天开	yi xiang tian kai
心焦如焚	xin jiao ru fen
出师不利	chu shi bu li
趋之若鹜	qu zhi ruo wu
设身处地	she shen chu di
损人利己	sun ren li ji
不得而知	bu de er zhi
精诚所至	jing cheng suo zhi
沉默寡言	chen mo gua yan
言过其实	yan guo qi shi
自食其果	zi shi qi guo
咄咄怪事	duo duo guai shi
心驰神往	xin chi shen wang
姗姗来迟	shan shan lai chi
泪如雨下	lei ru yu xia
刚愎自用	gang bi zi yong
问寒问暖	wen han wen nuan
春去秋来	chun qu qiu lai
得天独厚	de tian du hou
轻重缓急	qing zhong huan ji
平步青云	ping bu qing yun
乐此不倦	le ci bu juan
杯水车薪	bei shui che xin
不容置疑	bu rong zhi yi
错落有致	cuo luo you zhi
比翼双飞	bi yi shuang fei
不屈不挠	bu qu bu nao
痛哭流涕	tong ku liu ti
灿烂辉煌	can lan hui huang
手忙脚乱	shou mang jiao luan
出人意料	chu ren yi liao
百尺竿头	bai chi gan tou
开宗明义	kai zong ming yi
沁人肺腑	qin ren fei fu
指桑骂槐	zhi sang ma huai
坐以待毙	zuo yi dai bi
不得人心	bu de ren xin
不务正业	bu wu zheng ye
缺一不可	que yi bu ke
咬牙切齿	yao ya qie chi
诚心实意	cheng xin shi yi
一无所知	yi wu suo zhi
一厢情愿	yi xiang qing yuan
坚贞不屈	jian zhen bu qu
庖丁解牛	pao ding jie niu
相持不下	xiang chi bu xia
大有裨益	da you bi yi
一笔勾销	yi bi gou xiao
毫不在乎	hao bu zai hu
心旷神怡	xin kuang shen yi
岌岌可危	ji ji ke wei
举足轻重	ju zu qing zhong
面貌一新	mian mao yi xin
窃窃私语	qie qie si yu
天伦之乐	tian lun zhi le
东拉西扯	dong la xi che
山珍海味	shan zhen hai wei
似是而非	si shi er fei
恨之入骨	hen zhi ru gu
言行一致	yan xing yi zhi
心平气和	xin ping qi he
远走高飞	yuan zou gao fei
一帆风顺	yi fan feng shun
一针见血	yi zhen jian xie
力排众议	li pai zhong yi
半信半疑	ban xin ban yi
崇洋媚外	chong yang mei wai
恶言恶语	e yan e yu
油嘴滑舌	you zui hua she
千丝万缕	qian si wan lu
久别重逢	jiu bie chong feng
从头到尾	cong tou dao wei
如火如荼	ru huo ru tu
应付自如	ying fu zi ru
纨绔子弟	wan ku zi di
以柔克刚	yi rou ke gang
洞若观火	dong ruo guan huo
倾国倾城	qing guo qing cheng
痛心疾首	tong xin ji shou
打铁趁热	da tie chen re
五花八门	wu hua ba men
视若无睹	shi ruo wu du
断断续续	duan duan xu xu
飞黄腾达	fei huang teng da
争权夺利	zheng quan duo li
依依不舍	yi yi bu she
弃旧迎新	qi jiu ying xin
不毛之地	bu mao zhi di
其乐无穷	qi le wu qiong
人尽其才	ren jin qi cai
喋喋不休	die die bu xiu
真知灼见	zhen zhi zhuo jian
心如止水	xin ru zhi shui
单刀赴会	dan dao fu hui
犹豫不决	you yu bu jue
不可开交	bu ke kai jiao
先人后己	xian ren hou ji
引以为戒	yin yi wei jie
说长道短	shuo chang dao duan
艰苦卓绝	jian ku zhuo jue
无所适从	wu suo shi cong
无可否认	wu ke fou ren
绵里藏针	mian li cang zhen
牛郎织女	niu lang zhi nu
他山之石	ta shan zhi shi
耳闻目染	er wen mu ran
恰如其分	qia ru qi fen
造谣生事	zao yao sheng shi
理直气壮	li zhi qi zhuang
无补于事	wu bu yu shi
大智若愚	da zhi ruo yu
孤芳自赏	gu fang zi shang
一贫如洗	yi pin ru xi
风度翩翩	feng du pian pian
有志之士	you zhi zhi shi
难解难分	nan jie nan fen
不露声色	bu lu sheng se
目光如炬	mu guang ru ju
重于泰山	zhong yu tai shan
一表人材	yi biao ren cai
秋高气爽	qiu gao qi shuang
道貌岸然	dao mao an ran
千变万化	qian bian wan hua
老生常谈	lao sheng chang tan
大风大浪	da feng da lang
化整为零	hua zheng wei ling
沁人心脾	qin ren xin pi
将功补过	jiang gong bu guo
同舟共济	tong zhou gong ji
意气相投	yi qi xiang tou
各执一词	ge zhi yi ci
穷山僻壤	qiong shan pi rang
蛮横无理	man heng wu li
忘恩负义	wang en fu yi
一事无成	yi shi wu cheng
所见所闻	suo jian suo wen
人困马乏	ren kun ma fa
疲惫不堪	pi bei bu kan
朝夕相处	zhao xi xiang chu
能上能下	neng shang neng xia
理所当然	li suo dang ran
见多识广	jian duo shi guang
心狠手辣	xin hen shou la
以牙还牙	yi ya huan ya
名噪一时	ming zao yi shi
公正严明	gong zheng yan ming
不能自拔	bu neng zi ba
大汗淋漓	da han lin li
十恶不赦	shi e bu she
目无法纪	mu wu fa ji
情深似海	qing shen si hai
悬梁刺股	xuan liang ci gu
干脆利落	gan cui li luo
坐井观天	zuo jing guan tian
别具一格	bie ju yi ge
唯命是从	wei ming shi cong
青山绿水	qing shan lu shui
独立自主	du li zi zhu
繁荣富强	fan rong fu qiang
弄巧成拙	nong qiao cheng zhuo
深恶痛疾	shen wu tong ji
大书特书	da shu te shu
凯旋而归	kai xuan er gui
刻舟求剑	ke zhou qiu jian
嘘寒问暖	xu han wen nuan
满腹狐疑	man fu hu yi
秀外慧中	xiu wai hui zhong
童言无忌	tong yan wu ji
旗帜鲜明	qi zhi xian ming
猝不及防	cu bu ji fang
针锋相对	zhen feng xiang dui
喜不自禁	xi bu zi jin
能说会道	neng shuo hui dao
杯盘狼藉	bei pan lang ji
云开见日	yun kai jian ri
全神贯注	quan shen guan zhu
古往今来	gu wang jin lai
源源不绝	yuan yuan bu jue
宾至如归	bin zhi ru gui
缩手缩脚	suo shou suo jiao
根深叶茂	gen shen ye mao
蠢蠢欲动	chun chun yu dong
心慌意乱	xin huang yi luan
好事多磨	hao shi duo mo
一览无遗	yi lai wu yi
不分皂白	bu fen zao bai
扬扬得意	yang yang de yi
作威作福	zuo wei zuo fu
情真意切	qing zhen yi qie
单枪匹马	dan qiang pi ma
背信弃义	bei xin qi yi
人以群分	ren yi qun fen
不分彼此	bu fen bi ci
热泪盈眶	re lei ying kuang
高视阔步	gao shi kuo bu
开卷有益	kai juan you yi
先睹为快	xian du wei kuai
五内如焚	wu nei ru fen
慷慨陈词	kang kai chen ci
一点一滴	yi dian yi di
嬉皮笑脸	xi pi xiao lian
衣冠楚楚	yi guan chu chu
训练有素	xun lian you su
价廉物美	jia lian wu mei
占为己有	zhan wei ji you
势不可挡	shi bu ke dang
手到病除	shou dao bing chu
略逊一筹	lue xun yi chou
尽人皆知	jin ren jie zhi
勤勤恳恳	qin qin ken ken
强颜欢笑	qiang yan huan xiao
于心不忍	yu xin bu ren
不知进退	bu zhi jin tui
落井下石	luo jing xia shi
连绵不绝	lian mian bu jue
真心真意	zhen xin zhen yi
如梦初醒	ru meng chu xing
万事亨通	wan shi heng tong
倾家荡产	qing jia dang chan
排忧解难	pai you jie nan
泛滥成灾	fan lan cheng zai
置之脑后	zhi zhi nao hou
孤军奋战	gu jun fen zhan
始终如一	shi zhong ru yi
鹬蚌相争	yu bang xiang zheng
隔岸观火	ge an guan huo
触类旁通	chu lei pang tong
口是心非	kou shi xin fei
不分轻重	bu fen qing zhong
劳苦功高	lao ku gong gao
贪赃枉法	tan zang wang fa
外圆内方	wai yuan nei fang
衣衫褴褛	yi shan lan lu
坚强不屈	jian qiang bu qu
奋起直追	fen qi zhi zhui
龙腾虎跃	long teng hu yue
欲扬先抑	yu yang xian yi
一见钟情	yi jian zhong qing
以卵投石	yi luan tou shi
掩耳偷铃	yan er tou ling
痛不欲生	tong bu yu sheng
多事之秋	duo shi zhi qiu
应答如流	ying da ru liu
跃然纸上	yue ran zhi shang
破绽百出	po zhan bai chu
有凭有据	you ping you ju
滴水成冰	di shui cheng bing
付诸东流	fu zhu dong liu
同归于尽	tong gui yu jin
岁月如流	sui yue ru liu
危在旦夕	wei zai dan xi
铁石心肠	tie shi xin chang
吃里爬外	chi li pa wai
奋笔疾书	fen bi ji shu
毫不留情	hao bu liu qing
饥肠辘辘	ji chang lu lu
一片散沙	yi pian san sha
千篇一律	qian pian yi lu
各式各样	ge shi ge yang
英勇不屈	ying yong bu qu
机不可失	ji bu ke shi
轻手轻脚	qing shou qing jiao
刻不容缓	ke bu rong huan
易如翻掌	yi ru fan zhang
意犹未尽	yi you wei jin
人命关天	ren ming guan tian
情窦初开	qing dou chu kai
与虎谋皮	yu hu mou pi
深恶痛绝	shen wu tong jue
回天无力	hui tian wu li
旁门左道	pang men zuo dao
顺水推船	shun shui tui chuan
各有千秋	ge you qian qiu
拿手好戏	na shou hao xi
胆大包天	dan da bao tian
三心二意	san xin er yi
司空见惯	si kong jian guan
神不守舍	shen bu shou she
笑逐颜开	xiao zhu yan kai
一决胜负	yi jue sheng fu
眼疾手快	yan ji shou kuai
反复推敲	fan fu tui qiao
余音绕梁	yu yin rao liang
同床异梦	tong chuang yi meng
与人方便	yu ren fang bian
落地生根	luo di sheng gen
风吹草动	feng chui cao dong
逢场作戏	feng chang zuo xi
融汇贯通	rong hui guan tong
低三下四	di san xia si
飞来横祸	fei lai heng huo
富丽堂皇	fu li tang huang
实心实意	shi xin shi yi
由衷之言	you zhong zhi yan
嫌贫爱富	xian pin ai fu
狐朋狗友	hu peng gou you
言犹在耳	yan you zai er
出头之日	chu tou zhi ri
溜之大吉	liu zhi da ji
积土成山	ji shui wei shan
水泄不通	shui xie bu tong
功亏一篑	gong kui yi kui
行家里手	hang jia li shou
惊心动魄	jing xing dong po
一目十行	yi mu shi hang
讳莫如深	hui mo ru shen
如无其事	ru wu qi shi
守株待兔	shou zhu dai tu
乳臭未干	ru xiu wei gan
冠冕堂皇	guan mian tang huang
助纣为虐	zhu zhou wei nue
就地取材	jiu di qu cai
安安稳稳	an an wen wen
冲口而出	chong kou er chu
感人肺腑	gan ren fei fu
麻痹大意	ma bi da yi
千言万语	qian yan wan yu
一技之长	yi ji zhi chang
四面受敌	si mian shou di
臭味相投	xiu wei xiang tou
人穷志短	ren qiong zhi duan
动魄惊心	dong po jing xin
春光明媚	chun guang ming mei
千钧一发	qian jun yi fa
良辰美景	liang chen mei jing
咬紧牙关	yao jin ya guan
时来运转	shi lai yun zhuan
行尸走肉	xing shi zou rou
兵贵神速	bing gui shen su
东躲西藏	dong duo xi cang
大势已去	da shi yi qu
百战百胜	bai zhan bai sheng
外强中干	wai qiang zhong gan
装腔做势	zhuang qiang zuo shi
知难而退	zhi nan er tui
完整无缺	wan zheng wu que
剑拔弩张	jian ba nu zhang
狼窝虎穴	lang wo hu xue
一概而论	yi gai er lun
落花流水	luo hua liu shui
互相残杀	hu xiang can sha
有教无类	you jiao wu lei
名声扫地	ming sheng sao di
不切实际	bu qie shi ji
天怒人怨	tian nu ren yuan
形影相随	xing ying xiang sui
平分秋色	ping fen qiu se
刻苦耐劳	ke ku nai lao
有口难言	you kou nan yan
弹丸之地	dan wan zhi di
草船借箭	cao chuan jie jian
雷厉风行	lei li feng xing
宝刀未老	bao dao wei lao
夜深人静	ye shen ren jing
将错就错	jiang cuo jiu cuo
奋勇当先	fen yong dang xian
见贤思齐	jian xian si qi
游手好闲	you shou hao xian
不义之财	bu yi zhi cai
惊叹不已	jing tan bu yi
寒风刺骨	han feng ci gu
如鸟兽散	ru niao shou san
高山流水	gao shan liu shui
呼风唤雨	hu feng huan yu
黑白分明	hei bai fen ming
喜气洋洋	xi qi yang yang
不辞而别	bu ci er bie
谆谆教诲	zhun zhun jiao hui
自言自语	zi yan zi yu
博学多才	bo xue duo cai
将信将疑	jiang xin jiang yi
本性难移	ben xing nan yi
卓有成效	zhuo you cheng xiao
发愤图强	fa fen tu qiang
添油加醋	tian you jia cu
通情达理	tong qing da li
大动肝火	da dong gan huo
精忠报国	jing zhong bao guo
垂涎欲滴	chui xian yu di
一衣带水	yi yi dai shui
公平正直	gong ping zheng zhi
两肋插刀	liang lei cha dao
随心所欲	sui xin suo yu
装模做样	zhuang mo zuo yang
聪明过人	cong ming guo ren
有板有眼	you ban you yan
忠贞不渝	zhong zhen bu yu
一蹶不振	yi jue bu zhen
果然如此	guo ran ru ci
趋利避害	qu li bi hai
用武之地	yong wu zhi di
天道酬勤	tian dao chou qin
迥然不同	jiong ran bu tong
直截了当	zhi jie liao dang
一呼百应	yi hu bai ying
青云直上	qing yun zhi shang
哑口无言	ya kou wu yan
生搬硬套	sheng ban ying tao
酣畅淋漓	han chang lin li
理亏心虚	li kui xin xu
疾风劲草	ji feng jin cao
吹毛求疵	chui mao qiu ci
掷地有声	zhi di you sheng
铁板钉钉	tie ban ding ding
独力难支	du li nan zhi
防微杜渐	fang wei du jian
望风而逃	wang feng er tao
不可收拾	bu ke shou shi
叹为观止	tan wei guan zhi
趁火打劫	chen huo da jie
趁人之危	chen ren zhi wei
应对如流	ying dui ru liu
大义灭亲	da yi mie qin
开诚相见	kai cheng xiang jian
明枪暗箭	ming qiang an jian
国泰民安	guo tai min an
鬼斧神工	gui fu shen gong
天网恢恢	tian wang hui hui
一筹莫展	yi chou mo zhan
脸红耳赤	lian hong er chi
浑水摸鱼	hun shui mo yu
正中下怀	zheng zhong xia huai
无时无刻	wu shi wu ke
大街小巷	da jie xiao xiang
志在四方	zhi zai si fang
不时之需	bu shi zhi xu
事出有因	shi chu you yin
摇头晃脑	yao tou huang nao
海角天涯	hai jiao tian ya
灰心丧气	hui xin sang qi
丢三落四	diu san la si
不知深浅	bu zhi shen qian
言行不一	yan xing bu yi
人情冷暖	ren qing leng nuan
骇人听闻	hai ren ting wen
雅俗共赏	ya su gong shang
自作聪明	zi zuo cong ming
前程似锦	qian cheng si jin
偷梁换柱	tou liang huan zhu
感情用事	gan qing yong shi
欲盖弥彰	yu gai mi zhang
饥不择食	ji bu ze shi
彬彬有礼	bin bin you li
一气呵成	yi qi he cheng
一见如故	yi jian ru gu
闪烁其词	shan shuo qi ci
珠圆玉润	zhu yuan yu run
朝令夕改	zhao ling xi gai
争强好胜	zheng qiang hao sheng
耀武扬威	yao wu yang wei
不识抬举	bu shi tai ju
讳疾忌医	hui ji ji yi
身败名裂	shen bai ming lie
耸人听闻	song ren ting wen
持之以恒	chi zhi yi heng
茅塞顿开	mao se dun kai
十万火急	shi wan huo ji
邪门歪道	xie men wai dao
天旋地转	tian xuan di zhuan
求贤如渴	qiu xian ru ke
进退两难	jin tui liang nan
日以继夜	ri yi ji ye
有头有尾	you tou yuo wei
丢三拉四	diu san la si
大包大揽	da bao da lan
恩重如山	en zhong ru shan
火上添油	huo shang tian you
悔不当初	hui bu dang chu
碍手碍脚	ai shou ai jiao
不苟言笑	bu gou yan xiao
融为一体	rong wei yi ti
处之泰然	chu zhi tai ran
哀而不伤	ai er bu shang
博览群书	bo lan qun shu
贻笑大方	yi xiao da fang
无病呻吟	wu bing shen yin
人所共知	ren suo gong zhi
尽其所能	jin qi suo neng
重整旗鼓	chong zheng qi gu
大声疾呼	da sheng ji hu
不可言喻	bu ke yan yu
刻骨铭心	ke gu ming xin
入木三分	ru mu san fen
顺手牵羊	shun shou qian yang
朝不保夕	zhao bu bao xi
快马加鞭	kuai ma jia bian
生吞活剥	sheng tun huo bo
物极必反	wu ji bi fan
得意忘形	de yi wang xing
唇亡齿寒	chun wang chi han
捧腹大笑	peng fu da xiao
风云人物	feng yun ren wu
比比皆是	bi bi jie shi
宽洪大量	kuan hong da liang
群情鼎沸	qun qing ding fei
土崩瓦解	tu beng wa jie
痛快淋漓	tong kuai lin li
各行各业	ge hang ge ye
一望无垠	yi wang wu yin
毛遂自荐	mao sui zi jian
旧调重弹	jiu diao chong tan
灯火辉煌	deng huo hui huang
颠倒是非	dian dao shi fei
天真无邪	tian zhen wu xie
畏罪潜逃	wei zui qian tao
幡然悔悟	fan ran hui wu
画饼充饥	hua bing chong ji
废话连篇	fei hua lian pian
息事宁人	xi shi ning ren
按兵不动	an bing bu dong
好为人师	hao wei ren shi
不胫而走	bu jing er zou
手到擒来	shou dao qin lai
自命清高	zi ming qing gao
东张西望	dong zhang xi wang
大有裨益	da you bi yi
生死攸关	sheng si you guan
言之有理	yan zhi you li
璀璨夺目	cui can duo mu
摇头叹息	yao tou tan xi
言传身教	yan chuan shen jiao
地利人和	di li ren he
公事公办	gong shi gong ban
自不量力	zi bu liang li
从容不迫	cong rong bu po
不出所料	bu chu suo liao
独来独往	du lai du wang
上当受骗	shang dang shou pian
笨口拙舌	ben kou zhuo she
文过饰非	wen guo shi fei
潸然泪下	shan ran lei xia
大模大样	da mu da yang
誓不罢休	shi bu ba xiu
离经叛道	li jing pan dao
雪中送炭	xue zhong song tan
徒劳无功	tu lao wu gong
虎背熊腰	hu bei xiong yao
云开雾散	yun kai kai san
久闻大名	jiu wen da ming
纹丝不动	wen si bu dong
十字路口	shi zi lu kou
打退堂鼓	da tui tang gu
劈头盖脸	pi tou gai lian
实至名归	shi zhi ming gui
事关重大	shi guan zhong da
决一胜负	jue yi sheng fu
卧虎藏龙	wo hu cang long
无庸置疑	wu yong zhi yi
民不聊生	min bu liao sheng
如狼似虎	ru lang si hu
改头换面	gai tou huan mian
蛛丝马迹	zhu si ma ji
顾全大局	gu quan da ju
好学不倦	hao xue bu juan
雨后春笋	yu hou chun sun
金榜题名	jin bang ti ming
相知恨晚	xiang zhi hen wan
有声有色	you sheng you se
摇身一变	yao shen yi bian
能歌善舞	neng ge shan wu
喜笑颜开	xi xiao yan kai
三令五申	san ling wu shen
成年累月	cheng nian lei yue
扪心自问	men xin zi wen
不吝指教	bu lin zhi jiao
喜形于色	xi xing yu se
花枝招展	hua zhi zhao zhan
量入为出	liang ru wei chu
盛况空前	sheng kuang kong qian
七零八落	qi ling ba luo
屡见不鲜	lu jian bu xian
天赐良机	tian ci liang ji
名扬天下	ming yang tian xia
放下屠刀	fang xia tu dao
局促不安	ju cu bu an
意气风发	yi qi feng fa
变幻无常	bian huan wu chang
教导有方	jiao dao you fang
人多嘴杂	ren duo zui za
名不副实	ming bu fu shi
万籁俱寂	wan lai ju ji
沉思熟虑	chen si shu lu
和盘托出	he pan tuo chu
当之无愧	dang zhi wu kui
稳扎稳打	wen zha wen da
一览无余	yi lai wu yu
名山大川	ming shan da chuan
千差万别	qian cha wan bie
临阵脱逃	lin zhen tuo tao
生死存亡	sheng si cun wang
才气过人	cai qi guo ren
谦虚谨慎	qian xu jin shen
鼎鼎大名	ding ding da ming
化为泡影	hua wei pao ying
触目皆是	chu mu jie shi
兴味索然	xing wei suo ran
蒙在鼓里	meng zai gu li
黯然神伤	an ran shen shang
本来面目	ben lai mian mu
玩物丧志	wan wu sang zhi
尽收眼底	jin shou yan di
买椟还珠	mai du huan zhu
平淡无奇	ping dan wu qi
疑惑不解	yi huo bu jie
出人意外	chu ren yi wai
强弩之末	qiang nu zhi mo
勃然变色	bo ran bian se
相映成趣	xiang ying cheng qu
破涕为笑	po ti wei xiao
点点滴滴	dian dian di di
人言可畏	ren yan ke wei
事与愿违	shi yu yuan wei
历尽沧桑	li jin cang sang
大势所趋	da shi suo qu
顾名思义	gu ming si yi
苦中作乐	ku zhong zuo le
生离死别	sheng li si bie
胆颤心惊	dan chan xin jing
来龙去脉	lai long qu mai
引人注目	yin ren zhu mu
神气活现	shen qi huo xian
仓皇失措	cang huang shi cuo
百感交集	bai gan jiao ji
竭尽心力	jie jin xin li
置之不理	zhi zhi bu li
各有所长	ge you suo cheng
劳师动众	lao shi dong zhong
首当其冲	shou dang qi chong
玩火自焚	wan huo zi fen
受益无穷	shou yi wu qiong
扭转乾坤	niu zhuan qian kun
如梦方醒	ru meng fang xing
山明水秀	shan ming shui xiu
大败涂地	da bai tu di
惹是生非	re shi sheng fei
三顾茅庐	san gu mao lu
飞蛾扑火	fei e pu huo
狼狈不堪	lang bei bu kan
摩肩接踵	mo jian jie zhong
相安无事	xiang an wu shi
前因后果	qian yin hou guo
事半功倍	shi ban gong bei
破罐破摔	po guan po shuai
大器晚成	da qi wan cheng
明明白白	ming ming bai bai
大巧若拙	da qiao ruo zhuo
与世隔绝	yu shi ge jue
遮天蔽日	zhe tian bi ri
搬弄是非	ban nong shi fei
寥若晨星	liao ruo chen xing
不服水土	bu fu shui tu
心如刀绞	xin ru dao jiao
突飞猛进	tu fei meng jin
家常便饭	jia chang bian fan
一干二净	yi gan er jing
胡说八道	hu shuo ba dao
火急火燎	huo ji huo liao
一叶知秋	yi ye zhi qiu
一无可取	yi wu ke qu
初出茅庐	chu chu mao lu
古色古香	gu se gu xiang
危急关头	wei ji guan tou
形形色色	xing xing se se
犬牙交错	quan ya jiao cuo
愁眉苦脸	chou mei ku lian
战战兢兢	zhan zhan jing jing
天下为公	tian xia wei gong
重振旗鼓	chong zhen qi gu
别有风味	bie you feng wei
云消雾散	yun xiao wu san
沉默不语	chen mo bu yu
重蹈覆辙	chong dao fu zhe
过河拆桥	guo he chai qiao
一窍不通	yi qiao bu tong
闻鸡起舞	wen ji qi wu
恰到好处	qia dao hao chu
自怨自艾	zi yuan zi yi
鹤立鸡群	he li ji qun
一无所获	yi wu suo huo
怨气冲天	yuan qi chong tian
处心积虑	chu xin ji lu
千辛万苦	qian xin wan ku
眉飞眼笑	mei fei yan xiao
相得益彰	xiang de yi zhang
丝毫不差	si hao bu cha
人老珠黄	ren lao zhu huang
生气蓬勃	sheng qi bo bo
稍胜一筹	shao sheng yi chou
闭门思过	bi men si guo
易如反掌	yi ru fan zhang
不冷不热	bu leng bu re
百花争艳	bai hua zheng yan
一马当先	yi ma dang xian
绰绰有余	chuo chuo you yu
井底之蛙	jing di zhi wa
劳苦功高	lao ku gong gao
密密麻麻	mi mi ma ma
大张旗鼓	da zhang qi gu
日积月累	ri ji yue lei
风口浪尖	feng kou lang jian
笔下生花	bi xia sheng hua
天崩地裂	tian beng di lie
转忧为喜	zhuan you wei xi
齐心合力	qi xin he li
无边无际	wu bian wu ji
丧心病狂	sang xin bing kuang
逼上梁山	bi shang liang shan
精神涣散	jing shen huan san
不敢苟同	bu gan gou tong
晴天霹雳	qing tian pi li
闪烁其辞	shan shuo qi ci
人去楼空	ren qu lou kong
化为乌有	hua wei wu you
手不释卷	shou bu shi juan
大同小异	da tong xiao yi
青天白日	qing tian bai ri
抱打不平	bao da bu ping
以小见大	yi xiao jian da
自吹自擂	zi chui zi lei
一刀两断	yi dao liang duan
故态复萌	gu tai fu meng
显而易见	xian er yi jian
阳奉阴违	yang feng yin wei
鸠占鹊巢	jiu zhan que chao
遥遥无期	yao yao wu qi
有惊无险	you jing wu xian
停滞不前	ting zhi bu qian
万里长征	wan li chang zheng
一席之地	yi xi zhi di
奉公守法	feng gong shou fa
见义勇为	jian yi yong wei
相辅相成	xiang fu xiang cheng
神清气爽	shen qing qi shuang
聊以自慰	liao yi zi wei
引狼入室	yin lang ru shi
小题大做	xiao ti da zuo
喧宾夺主	xuan bin duo zhu
才疏学浅	cai shu xue qian
有口皆碑	you kou jie bei
独树一帜	du shu yi zhi
忐忑不安	tan te bu an
万事大吉	wan shi da ji
固执己见	gu zhi ji jian
席地而坐	xi di er zuo
有负众望	you fu zhong wang
伤天害理	shang tian hai li
束手无策	shu shou wu ce
前车可鉴	qian che ke jian
瞻前顾后	zhan qian gu hou
称兄道弟	cheng xiong dao di
有眼无珠	you yan wu zhu
两败俱伤	liang bai ju shang
鹏程万里	peng cheng wan li
见钱眼开	jian qian yan kai
硕果累累	shuo guo lei lei
十年寒窗	shi nian han chuang
独具慧眼	du ju hui yan
雨过天晴	yu guo tian qing
形单影只	xing dan ying zhi
大梦初醒	da meng chu xing
瞬息万变	shun xi wan bian
临机应变	lin ji ying bian
垂头丧气	chui tou sang qi
心心相印	xin xin xiang yin
八面威风	ba mian wei feng
提纲挈领	ti gang qie ling
满腔怒火	man qiang nu huo
助人为乐	zhu ren wei le
以身殉职	yi shen xun zhi
里应外合	li ying wai he
痛心疾首	tong xin ji shou
沸沸扬扬	fei fei yang yang
按捺不住	an na bu zhu
问心无愧	wen xin wu kui
险象环生	xian xiang huan sheng
语惊四座	yu jing si zuo
欲罢不能	yu ba bu neng
群策群力	qun ce qun li
百孔千疮	bai kong qian chuang
贪求无厌	tan qiu wu yan
恩将仇报	en jiang chou bao
坐视不理	zuo shi bu li
前所未有	qian suo wei you
一路顺风	yi lu shun feng
华而不实	hua er bu shi
别开生面	bie kai sheng mian
相貌堂堂	xiang mao tang tang
排山倒海	pai shan dao hai
相得益彰	xiang de yi zhang
大有作为	da you zuo wei
开诚布公	kai cheng bu gong
屡教不改	lu jian bu gai
事在人为	shi zai ren wei
奔流不息	ben liu bu xi
肃然起敬	su ran qi jing
留连忘返	liu lian wang fan
惟利是图	wei li shi tu
不足为奇	bu zu wei qi
相见恨晚	xiang jian hen wan
追本求源	zhui ben qiu yuan
起死回生	qi si hui sheng
气势磅礴	qi shi pang bo
柳暗花明	liu an hua ming
困兽犹斗	kun shou you dou
头昏眼花	tou hun yan hua
不寒而栗	bu han er li
天朗气清	tian lang qi qing
勤学苦练	qin xue ku zh
惊喜若狂	jing xi ruo kuang
先声夺人	xian sheng duo ren
奔走相告	ben zou xiang gao
名不虚传	ming bu xu chuan
十有八九	shi you ba jiu
劫富济贫	jie fu ji pin
可有可无	ke you ke wu
各执己见	ge zhi ji jian
没头没脑	mei tou mei nao
束手束脚	shu shou shu jiao
大摇大摆	da yao da bai
宽以待人	kuan yi dai ren
循循善诱	xun xun shan you
别无二致	bie wu er zhi
生机盎然	sheng ji ang ran
弹指之间	tan zhi zhi jian
无关紧要	wu guan jin yao
阿谀奉承	e yu feng cheng
恰中要害	qia zhong yao hai
察言观色	cha yan guan se
寸步不离	cun bu bu li
负荆请罪	fu jing qing zui
生龙活虎	sheng long huo hu
笨嘴拙舌	ben zui zhuo she
神魂颠倒	shen hun dian dao
波澜壮阔	bo lan zhuang kuo
扬眉吐气	yang mei tu qi
峰回路转	feng hui lu zhuan
无奇不有	wu qi bu you
诲人不倦	hui ren bu juan
洋洋洒洒	yang yang sa sa
妙趣横生	miao qu heng sheng
高风亮节	gao feng liang jie
已成定局	yi cheng ding ju
狼吞虎咽	lang tun hu yan
切中要害	qie zhong yao hai
先礼后兵	xian li hou bing
振振有词	zhen zhen you ci
无计可施	wu ji ke shi
孟母三迁	meng mu san qian
高深莫测	gao shen mo ce
妙笔生花	miao bi sheng hua
五光十色	wu guang shi se
步人后尘	bu ren hou chen
据为己有	ju wei ji you
恶性循环	e xing xun huan
所剩无几	suo sheng wu ji
简明扼要	jian ming e yao
耳熟能详	er shu neng xiang
一应俱全	yi ying ju quan
有始有终	you shi you zhong
穷困潦倒	qiong kun liao dao
夜郎自大	ye lang zi da
寡不敌众	gua bu di zhong
惊涛骇浪	jing tao hai lang
心神不宁	xin shen bu ning
威风扫地	wei feng sao di
躲躲闪闪	duo duo shan shan
交头接耳	jiao tou jie er
指指点点	zhi zhi dian dian
一挥而就	yi hui er jiu
一马平川	yi ma ping chuan
大有可为	da you ke wei
光阴似箭	guang yin si jian
事无巨细	shi wu ju xi
漠不关心	mo bu guan xin
一念之差	yi nian zhi cha
一石二鸟	yi shi er niao
无往不胜	wu wang bu sheng
生灵涂炭	sheng ling tu tan
天高气爽	tian gao qi shuang
立竿见影	li gan jian ying
黑白不分	hei bai bu fen
翻脸无情	fan lian wu qing
亦步亦趋	yi bu yi qu
笑而不答	xiao er bu da
秩序井然	zhi xu jing ran
指手画脚	zhi shou hua jiao
欢欣鼓舞	huan xin gu wu
清廉正直	qing lian zheng zhi
左右开弓	zuo you kai gong
横行天下	heng xing tian xia
不甘示弱	bu gan shi ruo
奋不顾身	fen bu gu shen
苍白无力	ang bai bui li
耿耿于怀	geng geng yu huai
豪情壮志	hao qing zhuang zhi
指鹿为马	zhi lu wei ma
火眼金睛	huo yan jin jing
张牙舞爪	zhang ya wu zhao
跃跃欲试	yue yue yu shi
不胜枚举	bu sheng mei ju
天下无敌	tian xia wu di
明日黄花	ming ri huang hua
座无空席	zuo wu kong xi
天南海北	tian nan hai bei
鸿鹄之志	hong hu zhi zhi
其乐融融	qi le rong rong
怒气冲天	nu qi chong tian
言谈举止	yan tan ju zhi
语重心长	yu zhong xin chang
不期而遇	bu qi er yu
魂不守舍	hun bu shou she
道听途说	dao ting tu shuo
只言片语	zhi yan pian yu
智勇双全	zhi yong shuang quan
车水马龙	che shui ma long
各显身手	ge xian shen shou
不分主次	bu fen zhu ci
总而言之	zong er yan zhi
声泪俱下	sheng lei ju xia
聊胜于无	liao sheng yu wu
逆来顺受	ni lai shun shou
叶落归根	ye luo gui gen
不卑不亢	bu bei bu kang
尊师重道	zun shi zhong dao
适得其反	shi de qi fan
丧尽天良	sang jin tian liang
固步自封	gu bu zi feng
大获全胜	da huo quan sheng
怒火冲天	nu huo chong tian
情投意合	qing tou yi he
大材小用	da cai xiao yong
梦寐以求	meng mei yi qiu
责无旁贷	ze wu pang dai
分秒必争	fen miao bi zheng
冒名顶替	mao ming ding ti
不耻下问	bu chi xia wen
循规蹈矩	xun gui dao ju
棋逢对手	qi feng dui shou
信口开河	xin kou kai he
一丝一毫	yi si yi hao
能者多劳	neng zhe duo lao
头晕目眩	tou yun mu xuan
心直嘴快	xin zhi zui kuai
牵强附会	qian qiang fu hui
夸大其辞	kua da qi ci
有的放矢	you di fang shi
恍然大悟	huang ran da wu
十拿九稳	shi na jiu wen
毫不含糊	hao bu han hu
一视同仁	yi shi tong ren
天旋地转	tian xuan di zhuan
老实巴交	lao shi ba jiao
独断专行	du duan zhuan xing
孜孜以求	zi zi yi qiu
吹灰之力	chui hui zhi li
心无城府	xin wu cheng fu
转危为安	zhuan wei wei an
目中无人	mu zhong wu ren
知错就改	zhi cuo jiu gai
风言风语	feng yan feng yu
反目成仇	fan mu cheng chou
揠苗助长	ya miao zhu zhang
独断专行	du duan zhuan xing
出人头地	chu ren tou di
九死一生	jiu si yi sheng
生花妙笔	sheng hua miao bi
耳濡目染	er ru mu ran
疲于奔命	pi yu ben ming
爱莫能助	ai mo neng zhu
含糊其词	han hu qi ci
近墨者黑	jin mo zhe hei
东躲西逃	dong duo xi tao
大逆不道	da ni bu dao
完璧归赵	wan bi gui zhao
听其自然	ting qi zi ran
盘根错节	pan gen cuo jie
十字路口	shi zi lu kou
小题大作	xiao ti da zuo
扶老携幼	fu lao xie you
众口纷纭	zhong kou fen yun
九牛一毛	jiu niu yi mao
至关重要	zhi guan zhong yao
匪夷所思	fei yi suo si
大饱眼福	da bao yan fu
杀气腾腾	sha qi teng teng
张口结舌	zhang kou jie she
引入歧途	yin ru qi tu
言而有信	yan er you xin
身无长物	shen wu zhang wu
声势浩大	sheng shi hao da
成双成对	cheng shuang cheng dui
留有余地	liu you yu di
截然不同	jie ran bu tong
如饥似渴	ru ji si ke
不择手段	bu ze shou duan
相敬如宾	xiang jing ru bin
悬而未决	xuan er wei jue
度日如年	du ri ru nian
功成身退	gong cheng shen tui
鸦雀无声	ya que wu sheng
危机四伏	wei ji si fu
动人心魄	dong ren xin po
痴心妄想	chi xin wang xiang
字里行间	zi li hang jian
光辉灿烂	guang hui can lan
博采众长	bo cai zhong chang
有胆有识	you dan you shi
令人捧腹	ling ren peng fu
世代相传	shi dai xiang chuan
形迹可疑	xing ji ke yi
不学无术	bu xue wu shu
劳民伤财	lao min shang cai
步步高升	bu bu gao sheng
仅此而已	jin ci er yi
闻风而动	wen feng er dong
慌张失措	huang zhang shi cuo
心灰意懒	xin hui yi lan
不可磨灭	bu ke mo mie
归根究柢	gui gen jiu di
千姿百态	qian zi bai tai
神机妙算	shen ji miao suan
一丘之貉	yi qiu zhi he
依依惜别	yi yi xi bie
深明大义	shen ming da yi
小菜一碟	xiao cai yi die
追根问底	zhui gen wen di
敬老爱幼	jing lao ai you
触景伤情	chu jing shang qing
脱口而出	tuo kou er chu
心惊胆寒	xin jing dan han
走南闯北	zou nan chuang bei
挥金如土	hui jin ru tu
索然无味	suo ran wu wei
愚不可及	yu bu ke ji
一朝一夕	yi zhao yi xi
无孔不入	wu kong bu ru
逍遥法外	xiao yao fa wai
生生不息	sheng sheng bu xi
唇枪舌剑	chun qiang she jian
横行无忌	heng xing wu ji
天寒地冻	tian han di dong
孤苦伶仃	gu ku ling ding
暗箭难防	an jian nan fang
丰衣足食	feng yi zu shi
天花乱坠	tian hua luan zhui
鹤发童颜	he fa tong yan
背道而驰	bei dao er chi
忧心如焚	you xin ru fen
浩然正气	hao ran zheng qi
同日而语	tong ri er yu
出谋划策	chu mou hua ce
英姿飒爽	ying zi sa shuang
怒气冲冲	nu qi chong chong
不明真相	bu ming zhen xiang
祸从口出	huo cong kou chu
杳无消息	yao wu xiao xi
旗鼓相当	qi gu xiang dang
赤胆忠心	chi dan zhong xin
知己知彼	zhi ji zhi bi
力所不及	li suo bu ji
大雨倾盆	da yu qing pen
天灾人祸	tian zai ren huo
大气磅礴	da qi pang bo
老当益壮	lao dang yi zhuang
独出心裁	du chu xin cai
诚心诚意	cheng xin cheng yi
公正廉明	gong zheng lian ming
眼尖手快	yan jian shou kuai
朝气勃勃	zhao qi bo bo
南辕北辙	nan yuan bei zhe
酸甜苦辣	suan tian ku la
一知半解	yi zhi ban jie
急流勇退	ji liu yong tui
报仇雪恨	bao chou xue hen
目不忍睹	mu bu ren du
后生可畏	hou sheng ke wei
轻如鸿毛	qing ru hong mao
捷报频传	jie bao pin chuan
支离破碎	zhi li po sui
见好就收	jian hao jiu shou
以人为本	yi ren wei ben
天南地北	tian nan di bei
刨根究底	pao gen jiu di
光阴如箭	guang yin ru jian
大败涂地	da bai tu di
饮水思源	yin shui si yuan
可圈可点	ke quan ke dian
翻来覆去	fan lai fu qu
乘胜追击	cheng sheng zhui ji
与日俱增	yu ri ju zeng
追根究底	zhui gen jiu di
监守自盗	jian shou zi dao
久负盛名	jiu fu sheng ming
无坚不摧	wu jian bu cui
眼高手低	yan gao shou di
煞费苦心	sha fei ku xin
锦绣河山	jin xiu he shan
以身试法	yi shen shi fa
一盘散沙	yi pan san sha
煞有介事	sha you jie shi
闭口不谈	bi kou bu tan
惴惴不安	zhui zhui bu an
翩翩起舞	pian pian qi wu
异途同归	yi tu tong gui
鸡毛蒜皮	ji mao suan pi
赤诚相待	chi cheng xiang dai
热情洋溢	re qing yang yi
遥遥在望	yao yao zai wang
光芒万丈	guang mang wan zhang
安然无恙	an ran wu yang
恋恋不舍	lian lian bu she
坐卧不安	zuo wo bu an
力争上游	li zheng shang you
辞不达意	ci bu da yi
楚楚动人	chu chu dong ren
大雪纷飞	da xue fen fei
杳无音信	yao wu yin xin
看家本领	kan jia ben ling
大是大非	da shi da fei
发人深省	fa ren shen xing
和颜悦色	he yan yue se
不可理喻	bu ke li yu
接踵而至	jie zhong er zhi
甘心情愿	gan xin qing yuan
豁达大度	huo da da du
公正无私	gong zheng wu si
风平浪静	feng ping lang jing
长途跋涉	chang tu ba she
一年半载	yi nian ban zai
勇往直前	yong wang zhi qian
如影随形	ru ying sui xing
匹夫有责	pi fu you ze
振聋发聩	zhen long fa kui
油腔滑调	you qiang hua diao
不堪设想	bu kan she xiang
孤注一掷	gu zhu yi zhi
天翻地覆	tian fan di fu
滴水穿石	di shui chuan shi
雄心勃勃	xiong xin bo bo
一目了然	yi mu liao ran
天真烂漫	tian zhen lan man
淡而无味	dan er wu wei
闻过则喜	wen guo ze xi
唯我独尊	wei wo du zun
每时每刻	mei shi mei ke
一意孤行	yi yi gu xing
功成名就	gong cheng ming jiu
旁敲侧击	pang qiao ce ji
无拘无束	wu ju wu shu
各得其所	ge de qi suo
举国上下	ju guo shang xia
军令如山	jun ling ru shan
江郎才尽	jiang lang cai jin
时过境迁	shi guo jing qian
冤家路窄	yuan jia lu zhai
难以预料	nan yi yu liao
绿水青山	lu shui qing shan
挑唆是非	tiao suo shi fei
另眼相看	ling yan xiang kan
冥思苦想	ming si ku xiang
溜须拍马	liu xu pai ma
拭目以待	shi mu yi dai
心花怒放	xin hua nu fang
珠光宝气	zhu guang bao qi
排除万难	pai chu wan nan
两袖清风	liang xiu qing feng
除旧布新	chu jiu bu xin
三番五次	san fan wu ci
如法炮制	ru fa pao zhi
数一数二	shu yi shu er
箭拔弩张	jian ba nu zhang
前无古人	qian wu gu ren
无穷无尽	wu qiong wu jin
明目张胆	ming mu zhang dan
只争朝夕	zhi zheng zhao xi
草率行事	cao shuai xing shi
虚惊一场	xu jing yi chang
蹉跎岁月	cuo tuo sui yue
一腔热血	yi qiang re xue
离题万里	li ti wan li
顿开茅塞	dun kai mao se
以人为镜	yi ren wei jing
黄粱美梦	huang liang mei meng
喜不自胜	xi bu zi sheng
怀才不遇	huai cai bu yu
惊慌失措	jing huang shi cuo
中途而废	zhong tu er fei
徇私舞弊	xun si wu bi
掩耳盗铃	yan er dao ling
开门揖盗	kai men yi dao
人心惶惶	ren xin huang huang
罪有应得	zui you ying de
嫉恶如仇	ji e ru chou
形影不离	xing ying bu li
春风得意	chun feng de yi
令人发指	ling ren fa zhi
藏头露尾	cang tou lu wei
目不转睛	mu bu zhuan jing
迎头痛击	ying tou tong ji
全心全意	quan xin quan yi
荒无人烟	huang wu ren yan
手急眼快	shou ji yan kuai
炎黄子孙	yan huang zi sun
囊空如洗	nang kong ru xi
急转直下	ji zhuan zhi xia
顾此失彼	gu ci shi bi
精明能干	jing ming neng gan
堂堂正正	tang tang zheng zheng
板上钉钉	ban shang ding ding
泰山压顶	tai shan ya ding
乌合之众	wu he zhi zhong
锋芒逼人	feng mang bi ren
自以为是	zi yi wei shi
急风骤雨	ji feng zhou yu
小心翼翼	xiao xin yi yi
倚强凌弱	yi qiang ling ruo
春寒料峭	chun han liao qiao
昂首阔步	ang shou kuo bu
情不自禁	qing bu zi jin
细水长流	xi shui chang liu
海纳百川	hai na bai chuan
循序渐进	xun xu jian jin
栩栩如生	xu xu ru sheng
死而后已	si er hou yi
别有洞天	bie you dong tian
狂风骤雨	kuang feng zhou yu
转瞬之间	zhuan shun zhi jian
避重就轻	bi zhong jiu qing
自愧弗如	zi kui fu ru
赏心悦目	shang xin yue mu
杳无踪影	yao wu zong ying
言外之意	yan wai zhi yi
心灵手巧	xin ling shou qiao
高人一等	gao ren yi deng
从中作梗	cong zhong zuo geng
可乘之机	ke cheng zhi ji
春色满园	chun se man yuan
死灰复燃	si hui fu ran
败兴而归	bai xing er gui
粗茶淡饭	cu cha dan fan
扬扬自得	yang yang zi de
支支吾吾	zhi zhi wu wu
意外之财	yi wai zhi cai
穷凶极恶	qiong xiong ji e
不分上下	bu fen shang xia
灵机一动	ling ji yi dong
在所难免	zai suo nan mian
饶有兴趣	rao you xing qu
因材施教	yin cai shi jiao
三更半夜	san geng ban ye
防患未然	fang huan wei ran
力不能及	li bu neng ji
名正言顺	ming zheng yan shun
随波逐流	sui bo zhu liu
悔之无及	hui zhi wu ji
瞪目结舌	deng mu jie she
难以为情	nan yi wei qing
貌合神离	mao he shen li
两全其美	liang quan qi mei
感恩戴德	gan en dai de
全军覆没	quan jun fu mo
草率了事	cao shuai liao shi
疾恶如仇	ji e ru chou
狂风巨浪	kuang feng ju lang
故技重演	gu ji chong yan
心照不宣	xin zhao bu xuan
通俗易懂	tong su yi dong
鱼目混珠	yu mu hun zhu
物美价廉	jia lian wu mei
流连忘返	liu lian wang fan
雷霆万钧	lei ting wan jun
摇摇欲坠	yao yao yu zhui
天赐良机	tian ci liang ji
野心勃勃	ye xin bo bo
可见一斑	ke jian yi ban
头昏脑胀	tou hun nao zhang
动人心魄	dong ren xin po
固守成规	gu shou cheng gui
水深火热	shui shen huo re
近在咫尺	jin zai zhi chi
栋梁之材	dong liang zhi cai
举手投足	ju shou tou zu
百无聊赖	bai wu liao lai
东施效颦	dong shi xiao pin
无可置疑	wu ke zhi yi
见机行事	jian ji xing shi
不识好歹	bu shi hao dai
山清水秀	shan qing shui xiu
自我陶醉	zi wo tao zui
一斑窥豹	yi ban kui bao
不可逾越	bu ke yu yue
独辟蹊径	du pi xi jing
半途而废	ban tu er fei
多才多艺	duo cai duo yi
辉煌夺目	hui huang duo mu
独一无二	du yi wu er
阴错阳差	yin cuo yang cha
难以启齿	nan yi qi chi
磨拳擦掌	mo quan ca zhang
千头万绪	qian tou wan xu
捕风捉影	bu feng zhuo ying
别树一帜	bie shu yi zhi
不辞辛苦	bu ci xin ku
振奋人心	zhen fen ren xin
粥少僧多	zhou shao seng duo
前所未有	qian suo wei you
生搬硬套	sheng ban ying tao
感同身受	gan tong shen shou
图穷匕现	tu qiong bi xian
图谋不轨	tu mou bu gui
适可而止	shi ke er zhi
有勇无谋	you yong wu mou
无所忌惮	wu suo ji dan
才貌双全	cai mao shuang quan
想方设法	xiang fang she fa
有始无终	you shi wu zhong
光阴荏苒	guang yin ren ran
生龙活虎	sheng long huo hu
力透纸背	li tou zhi bei
鸡鸣狗盗	ji ming gou dao
蜂拥而上	feng yong er shang
名落孙山	ming luo sun shan
半路出家	ban lu chu jia
昏昏欲睡	hun hun yu shui
恩怨分明	en yuan fen ming
大显身手	da xian shen shou
趾高气扬	zhi gao qi yang
古道热肠	gu dao re chang
手舞足蹈	shou wu zu dao
德才兼备	de cai jian bei
牢不可破	lao bu ke po
五体投地	wu ti tou di
连绵起伏	lian mian qi fu
踌躇不定	chou chu bu ding
伶牙俐齿	ling ya li chi
将心比心	jiang xin bi xin
展翅高飞	zhan chi gao fei
千夫所指	qian fu suo zhi
山盟海誓	shan meng hai shi
书声琅琅	shu sheng lang lang
东拼西凑	dong pin xi cou
实话实说	shi hua shi shuo
胸怀大志	xiong huai da zhi
继往开来	ji wang kai lai
矢志不渝	shi zhi bu yu
南柯一梦	nan ke yi meng
窗明几净	chuang ming ji jing
守望相助	shou wang xiang zhu
十万火急	shi wan huo ji
冷眼旁观	leng yan pang guan
欲擒故纵	yu qin gu zong
命悬一线	ming xuan yi xian
转败为胜	zhuan bai wei sheng
不同凡响	bu tong fan xiang
儿女情长	er nu qing chang
乘兴而来	cheng xing er lai
非同小可	fei tong xiao ke
由浅入深	you qian ru shen
当局者迷	dang ju zhe mi
失声痛哭	shi sheng tong ku
人才辈出	ren cai bei chu
万家灯火	wan jia deng huo
黄粱一梦	huang liang yi meng
如鲠在喉	ru geng zai hou
无足挂齿	wu zu gua chi
闷闷不乐	men men bu le
家贼难防	jia zei nan fang
不拘小节	bu ju xiao jie
问心有愧	wen xin you kui
愚昧无知	yu mei wu zhi
十室九空	shi shi jiu kong
热血沸腾	re xue fei teng
悠闲自在	you xian zi zai
琳琅满目	lin lang man mu
弦外之音	xian wai zhi yin
不可饶恕	bu ke rao shu
化整为零	hua zheng wei ling
悄无声息	qiao wu sheng xi
节外生枝	jie wai sheng zhi
拈轻怕重	nian qing pa zhong
轻描淡写	qing miao dan xie
春风满面	chun feng man mian
龇牙咧嘴	zi ya lie zui
漏网之鱼	lou wang zhi yu
有利有弊	you li you bi
骄奢淫逸	jiao she yin yi
愤愤不平	fen fen bu ping
一文不值	yi wen bu zhi
口口相传	kou kou xiang chuan
蓬头散发	peng tou san fa
和气生财	he qi sheng cai
叫苦不迭	jiao ku bu die
悔之不及	hui zhi bu ji
百思不解	bai si bu jie
豁然贯通	huo ran guan tong
乐而忘返	le er wang fan
关怀备至	guan huai bei zhi
恃强凌弱	shi qiang ling ruo
看风使舵	kan feng shi duo
真枪实弹	zhen qiang shi dan
溢于言表	yi yu yan biao
混淆是非	hun xiao shi fei
亲如手足	qin ru shou zu
忍俊不禁	ren jun bu jin
物是人非	wu shi ren fei
真凭实据	zhen ping shi ju
取而代之	qu e dai zhi
一言难尽	yi yan nan jin
敢做敢当	gan zuo gan dang
藕断丝连	ou duan si lian
鱼死网破	yu si wang po
放马后炮	fang ma hou pao
一饮而尽	yi yin er jin
不足为虑	bu zu wei lu
抱残守缺	bao can shou que
孑然一身	jie ran yi shen
