一丘之貉	yi qiu zhi he
一丝一毫	yi si yi hao
一丝不挂	yi si bu gua
一丝不苟	yi si bu gou
一举一动	yi ju yi dong
一举两得	yi ju liang de
一举成名	yi ju cheng ming
一了百了	yi liao bai liao
一事无成	yi shi wu cheng
一五一十	yi wu yi shi
一以贯之	yi yi guan zhi
一元复始	yi yuan fu shi
一决胜负	yi jue sheng fu
一决雌雄	yi jue ci xiong
一击即溃	yi ji ji kui
一刀两断	yi dao liang duan
一分为二	yi fen wei er
一刹那间	yi cha na jian
一刻千金	yi ke qian jin
一力承担	yi li cheng dan
一动不动	yi dong bu dong
一劳永逸	yi lao yong yi
一厢情愿	yi xiang qing yuan
一去不返	yi qu bu fan
一反常态	yi fan chang tai
一口咬定	yi kou yao ding
一叶知秋	yi ye zhi qiu
一叶障目	yi ye zhang mu
一吐为快	yi tu wei kuai
一呼百和	yi hu bai he
一呼百应	yi hu bai ying
一命呜呼	yi ming wu hu
一哄而上	yi hong er shang
一哄而散	yi hong er san
一哄而起	yi hong er qi
一唱一和	yi chang yi he
一唱三叹	yi chang san tan
一团和气	yi tuan he qi
一团漆黑	yi tuan qi hei
一塌糊涂	yi ta hu tu
一声不吭	yi sheng bu keng
一声不响	yi sheng bu xiang
一夫当关	yi fu dang guan
一头雾水	yi tou wu shui
一如既往	yi ru ji wang
一孔之见	yi kong zhi jian
一字一句	yi zi yi ju
一字不差	yi zi bu cha
一字不落	yi zi bu la
一字之师	yi zi zhi shi
一字千金	yi zi qian jin
一官半职	yi guan ban zhi
一家之主	yi jia zhi zhu
一家之言	yi jia zhi yan
一家老小	yi jia lao xiao
一尘不染	yi chen bu ran
一己之私	yi ji zhi si
一己之见	yi ji zhi jian
一帆风顺	yi fan feng shun
一席之地	yi xi zhi di
一干二净	yi gan er jing
一年一度	yi nian yi du
一年到头	yi nian dao tou
一年半载	yi nian ban zai
一应俱全	yi ying ju quan
一式一样	yi shi yi yang
一张一弛	yi zhang yi chi
一往情深	yi wang qing shen
一往无前	yi wang wu qian
一往直前	yi wang zhi qian
一心一意	yi xin yi yi
一心两用	yi xin liang yong
一念之差	yi nian zhi cha
一息尚存	yi xi shang cun
一意孤行	yi yi gu xing
一成不变	yi cheng bu bian
一手包办	yi shou bao ban
一手包揽	yi shou bao lan
一手遮天	yi shou zhe tian
一扫而光	yi sao er guang
一扫而空	yi sao er kong
一技之长	yi ji zhi chang
一拍即合	yi pai ji he
一拥而上	yi yong er shang
一拥而入	yi yong er ru
一挥而就	yi hui er jiu
一掷千金	yi zhi qian jin
一文不值	yi wen bu zhi
一文不名	yi wen bu ming
一斑窥豹	yi ban kui bao
一无可取	yi wu ke qu
一无所得	yi wu suo de
一无所成	yi wu suo cheng
一无所有	yi wu suo you
一无所求	yi wu suo qiu
一无所知	yi wu suo zhi
一无所获	yi wu suo huo
一无所长	yi wu suo chang
一无是处	yi wu shi chu
一日三秋	yi ri san qiu
一日千里	yi ri qian li
一时半刻	yi shi ban ke
一星半点	yi xing ban dian
一曝十寒	yi pu shi han
一望无垠	yi wang wu yin
一望无边	yi wang wu bian
一望无际	yi wang wu ji
一望而知	yi wang er zhi
一朝一夕	yi zhao yi xi
一木难支	yi mu nan zhi
一本万利	yi ben wan li
一本正经	yi ben zheng jing
一来二去	yi lai er qu
一来二往	yi lai er wang
一板一眼	yi ban yin yan
一枝独秀	yi zhi du xiu
一概而论	yi gai er lun
一槌定音	yi chui ding yin
一模一样	yi mo yi yang
一步到位	yi bu dao wei
一步登天	yi bu deng tian
一毛不拔	yi mao bu ba
一毫不差	yi hao bu cha
一气呵成	yi qi he cheng
一波三折	yi bo san zhe
一泻千里	yi xie qian li
一派胡言	yi pai hu yan
一清二楚	yi qing er chu
一清二白	yi qing er bai
一潭死水	yi tan si shui
一炮打响	yi pao da xiang
一点一滴	yi dian yi di
一片丹心	yi pian dan xin
一片散沙	yi pian san sha
一片汪洋	yi pian wang yang
一片漆黑	yi pian qi hei
一生一世	yi sheng yi shi
一病不起	yi bing bu qi
一盘散沙	yi pan san sha
一目了然	yi mu liao ran
一目十行	yi mu shi hang
一相情愿	yi xiang qing yuan
一知半解	yi zhi ban jie
一石二鸟	yi shi er niao
一穷二白	yi qiong er bai
一窍不通	yi qiao bu tong
一笑了之	yi xiao liao zhi
一笑置之	yi xiao zhi zhi
一笔勾销	yi bi gou xiao
一筹莫展	yi chou mo zhan
一箭之遥	yi jian zhi yao
一箭双雕	yi jian shuang diao
一纸空文	yi zhi kong wen
一线希望	yi xian xi wang
一线生机	yi xian sheng ji
一统天下	yi tong tian xia
一网打尽	yi wang da jin
一股脑儿	yi gu nao er
一脉相传	yi mai xiang chuan
一脉相承	yi mai xiang cheng
一脉相通	yi mai xiang tong
一腔热血	yi qiang re xue
一臂之力	yi bi zhi li
一般见识	yi ban jian shi
一草一木	yi cao yi mu
一落千丈	yi luo qian zhang
一衣带水	yi yi dai shui
一表人才	yi biao ren cai
一表人材	yi biao ren cai
一见倾心	yi jian qing xin
一见如故	yi jian ru gu
一见钟情	yi jian zhong qing
一视同仁	yi shi tong ren
一览无余	yi lai wu yu
一览无遗	yi lai wu yi
一触即发	yi chu ji fa
一触即溃	yi chu ji kui
一言一行	yi yan yi xing
一言不发	yi yan bu fa
一言不合	yi yan bu he
一言为定	yi yan wei ding
一言九鼎	yi yan jiu ding
一言难尽	yi yan nan jin
一语中的	yi yu zhong di
一语双关	yi yu shuang guan
一语破的	yi yu po di
一语道破	yi yu dao po
一误再误	yi wu zai wu
一诺千金	yi nuo qian jin
一败涂地	yi bai tu di
一贫如洗	yi pin ru xi
一走了之	yi zou liao zhi
一路平安	yi lu ping an
一路货色	yi lu huo se
一路顺风	yi lu shun feng
一蹴而就	yi cu er jiu
一蹶不振	yi jue bu zhen
一身是胆	yi shen shi dan
一通百通	yi tong bai tong
一针一线	yi zhen yi xian
一针见血	yi zhen jian xie
一钱不值	yi qian bu zhi
一错再错	yi cuo zai cuo
一锤定音	yi chui ding yin
一门心思	yi men xin si
一隅之见	yi yu zhi jian
一面之交	yi mian zhi jiao
一面之缘	yi mian zhi yuan
一面之词	yi mian zhi ci
一面之辞	yi mian zhi ci
一颦一笑	yi pin yi xiao
一飞冲天	yi fei chong tian
一饮而尽	yi yin er jin
一饱眼福	yi bao yan fu
一马平川	yi ma ping chuan
一马当先	yi ma dang xian
一鸣惊人	yi ming jing ren
一鼓作气	yi gu zuo qi
一鼻子灰	yi bi zi hui
七七八八	qi qi ba ba
七上八下	qi shang ba xia
七嘴八舌	qi zui ba she
七弯八拐	qi wan ba guai
七情六欲	qi qing liu yu
七手八脚	qi shou ba jiao
七扭八歪	qi niu ba wai
七拉八扯	qi la ba che
七拼八凑	qi pin ba cou
七步成诗	qi bu cheng shi
七歪八扭	qi wai ba niu
七窍生烟	qi qiao sheng yan
七老八十	qi lao ba shi
七零八落	qi ling ba luo
七颠八倒	qi dian ba dao
万丈深渊	wan zhang shen yuan
万不得已	wan bu de yi
万世流芳	wan shi liu fang
万事亨通	wan shi heng tong
万事大吉	wan shi da ji
万事如意	wan shi ru yi
万人空巷	wan ren kong xiang
万众一心	wan zhong yi xin
万全之策	wan quan zhi ce
万劫不复	wan jie bu fu
万古不变	wan gu bu bian
万古流芳	wan gu liu fang
万古长青	wan gu chang qing
万家灯火	wan jia deng huo
万念俱灰	wan nian ju hui
万无一失	wan wu yi shi
万死不辞	wan si bu ci
万水千山	wan shui qian shan
万箭穿心	wan jian chuan xin
万籁俱寂	wan lai ju ji
万籁俱静	wan lai ju jing
万籁无声	wan lai wu sheng
万紫千红	wan zi qian hong
万般无奈	wan ban wu nai
万象更新	wan xiang geng xin
万贯家财	wan guan jia cai
万里无云	wan li wu yun
万里长城	wan li chang cheng
万里长征	wan li chang zheng
万马奔腾	wan ma ben teng
三三两两	san san liang liang
三五成群	san wu cheng qun
三人成虎	san ren cheng hu
三令五申	san ling wu shen
三位一体	san wei yi ti
三六九等	san liu jiu deng
三十而立	san shi er li
三天两头	san tian liang tou
三头六臂	san tou liu bi
三妻四妾	san qi si qie
三姑六婆	san gu liu po
三山五岳	san shan wu yue
三年五载	san nian wu zai
三心二意	san xin er yi
三思而行	san si er xing
三教九流	san jiao jiu liu
三更半夜	san geng ban ye
三生有幸	san sheng you xing
三番两次	san fan liang ci
三番五次	san fan wu ci
三省吾身	san xing wu shen
三缄其口	san jian qi kou
三言两语	san yan liang yu
三足鼎立	san zu ding li
三长两短	san chang liang duan
三阳开泰	san yang kai tai
三顾茅庐	san gu mao lu
三顾草庐	san gu cao lu
上上下下	shang shang xia xia
上下一心	shang xia yi xin
上下打量	shang xia da liang
上吐下泻	shang tu xia xie
上善若水	shang shan ruo shui
上天入地	shang tian ru di
上当受骗	shang dang shou pian
上情下达	shang qing xia da
上梁不正	shang liang bu zheng
上窜下跳	shang cuan xia tiao
上行下效	shang xing xia xiao
上蹿下跳	shang cuan xia tiao
下不为例	xia bu wei li
下不了台	xia bu le tai
下不来台	xia bu lai tai
下情上达	xia qing shang da
下笔成章	xia bi cheng zhang
下落不明	xia luo bu ming
下逐客令	xia zhu ke ling
下里巴人	xia li ba ren
下马看花	xia ma kan hua
不一而足	bu yi er zu
不三不四	bu san bu si
不上不下	bu shang bu xia
不义之财	bu yi zhi cai
不乏先例	bu fa xian li
不乏其人	bu fa qi ren
不了了之	bu liao liao zhi
不二法门	bu er fa men
不亢不卑	bu kang bu bei
不亦乐乎	bu yi le hu
不仁不义	bu ren bu yi
不以为奇	bu yi wei qi
不以为意	bu yi wei yi
不以为然	bu yi wei ran
不以为耻	bu yi wei chi
不伦不类	bu lun bu lei
不依不饶	bu yi bu rao
不修边幅	bu xiu bian fu
不值一钱	bu zhi yi qian
不假思索	bu jia si suo
不偏不倚	bu pian bu yi
不共戴天	bu gong dai tian
不关痛痒	bu guan tong yang
不冷不热	bu leng bu re
不出所料	bu chu suo liao
不分上下	bu fen shang xia
不分主次	bu fen zhu ci
不分伯仲	bu fen bo zhong
不分彼此	bu fen bi ci
不分皂白	bu fen zao bai
不分胜负	bu fen sheng fu
不分轻重	bu fen qing zhong
不分高下	bu fen gao xia
不切实际	bu qie shi ji
不加思索	bu jia si suo
不务正业	bu wu zheng ye
不动声色	bu dong sheng se
不劳而获	bu lao er huo
不卑不亢	bu bei bu kang
不即不离	bu ji bu li
不厌其烦	bu yan qi fan
不厌其详	bu yan qi xiang
不可一世	bu ke yi shi
不可企及	bu ke qi ji
不可估量	bu ke gu liang
不可侵犯	bu ke qin fan
不可偏废	bu ke pian fei
不可分割	bu ke fen ge
不可动摇	bu ke dong yao
不可名状	bu ke ming zhuang
不可告人	bu ke gao ren
不可多得	bu ke duo de
不可开交	bu ke kai jiao
不可思议	bu ke si yi
不可抗拒	bu ke kang ju
不可捉摸	bu ke zhuo mo
不可收拾	bu ke shou shi
不可救药	bu ke jiu yao
不可理喻	bu ke li yu
不可磨灭	bu ke mo mie
不可终日	bu ke zhong ri
不可缺少	bu ke que shao
不可胜数	bu ke sheng shu
不可言传	bu ke yan chuan
不可言喻	bu ke yan yu
不可轻视	bu ke qing shi
不可辩驳	bu ke bian bo
不可逾越	bu ke yu yue
不可避免	bu ke bi mian
不可限量	bu ke xian liang
不可饶恕	bu ke rao shu
不合时宜	bu he shi yi
不同凡响	bu tong fan xiang
不吐不快	bu tu bu kuai
不吝指教	bu lin zhi jiao
不吝赐教	bu lin ci jiao
不咸不淡	bu xian bu dan
不在话下	bu zai hua xia
不堪一击	bu kan yi ji
不堪入目	bu kan ru mu
不堪入耳	bu kan ru er
不堪回首	bu kan hui shou
不堪设想	bu kan she xiang
不声不响	bu sheng bu xiang
不失时机	bu shi shi ji
不好意思	bu hao yi si
不孝之子	bu xiao zhi zi
不学无术	bu xue wu shu
不宣而战	bu xuan er zhan
不容争辩	bu rong zheng bian
不容分说	bu rong fen shuo
不容置疑	bu rong zhi yi
不容置辩	bu rong zhi bian
不寒而栗	bu han er li
不屈不挠	bu qu bu nao
不屑一顾	bu xie yi gu
不屑置辩	bu xie zhi bian
不干不净	bu gan bu jing
不平则鸣	bu ping ze ming
不徇私情	bu xun si qing
不得人心	bu de ren xin
不得善终	bu de shan zhong
不得而知	bu de er zhi
不得要领	bu de yao ling
不念旧情	bu nian jiu qing
不怀好意	bu huai hao yi
不惑之年	bu huo zhi nian
不惜一切	bu xi yi qie
不惜代价	bu xi dai jia
不惜工本	bu xi gong ben
不惜血本	bu xi xue ben
不慌不忙	bu huang bu mang
不懂装懂	bu dong zhuang dong
不成体统	bu cheng ti tong
不成方圆	bu cheng fang yuan
不成气候	bu cheng qi hou
不打自招	bu da zi zhao
不折不扣	bu zhe bu kou
不拘一格	bu ju yi ge
不拘小节	bu ju xiao jie
不择手段	bu ze shou duan
不攻自破	bu gong zi po
不敢苟同	bu gan gou tong
不敢高攀	bu gan gao pan
不时之需	bu shi zhi xu
不明不白	bu ming bu bai
不明事理	bu ming shi li
不明真相	bu ming zhen xiang
不服水土	bu fu shui tu
不期而遇	bu qi er yu
不欢而散	bu huan er san
不正之风	bu zheng zhi feng
不毛之地	bu mao zhi di
不求甚解	bu qiu shen jie
不治之症	bu zhi zhi zheng
不法之徒	bu fa zhi tu
不清不白	bu qing bu bai
不理不睬	bu li bu cai
不甘后人	bu gan hou ren
不甘寂寞	bu gan ji mo
不甘示弱	bu gan shi ruo
不由分说	bu you fen shuo
不由自主	bu you zi zhu
不留余地	bu liu yu di
不留痕迹	bu liu hen ji
不疾不徐	bu ji bu xu
不痛不痒	bu tong bu yang
不瘟不火	bu wen bu huo
不白之冤	bu bai zhi yuan
不相上下	bu xiang shang xia
不省人事	bu xing ren shi
不眠之夜	bu mian zhi ye
不着边际	bu zhuo bian ji
不知不觉	bu zhi bu jue
不知去向	bu zhi qu xiang
不知好歹	bu zhi hao dai
不知底细	bu zhi di xi
不知所云	bu zhi suo yun
不知所以	bu zhi suo yi
不知所措	bu zhi suo cuo
不知所终	bu zhi suo zhong
不知死活	bu zhi si huo
不知深浅	bu zhi shen qian
不知轻重	bu zhi qing zhong
不知进退	bu zhi jin tui
不破不立	bu puo bu li
不祥之兆	bu xiang zhi zhao
不管不顾	bu guan bu gu
不紧不慢	bu jin bu man
不约而同	bu yue er tong
不绝于耳	bu jue yu er
不绝如缕	bu jue ru lu
不置可否	bu zhi ke fou
不翼而飞	bu yi er fei
不耻下问	bu chi xia wen
不肖子孙	bu xiao zi sun
不胜其烦	bu sheng qi fan
不胜枚举	bu sheng mei ju
不胫而走	bu jing er zou
不能自已	bu neng zi yi
不能自拔	bu neng zi ba
不自量力	bu zi liang li
不苟言笑	bu gou yan xiao
不落人后	bu luo ren hou
不落俗套	bu luo su tao
不落窠臼	bu luo ke jiu
不虚此行	bu xu ci xing
不见天日	bu jian tian ri
不见经传	bu jian jing zhuan
不解之缘	bu jie zhi yuan
不解之谜	bu jie zhi mi
不言不语	bu yan bu yu
不言而喻	bu yan er yu
不计其数	bu ji qi shu
不识大体	bu shi da ti
不识好歹	bu shi hao dai
不识抬举	bu shi tai ju
不识时务	bu shi shi wu
不识泰山	bu shi tai shan
不请自来	bu qing zi lai
不谋而合	bu mou er he
不谋而同	bu mou er tong
不负众望	bu fu zhong wang
不败之地	bu bai zhi di
不足为凭	bu zu wei ping
不足为奇	bu zu wei qi
不足为怪	bu zu wei guai
不足为据	bu zu wei ju
不足为虑	bu zu wei lu
不足为训	bu zu wei xun
不足之处	bu zu zhi chu
不足挂齿	bu zu gua chi
不辞劳苦	bu ci lao ku
不辞而别	bu ci er bie
不辞辛劳	bu ci xin lao
不辞辛苦	bu ci xin ku
不辨真伪	bu bian zhen wei
不辱使命	bu ru shi ming
不近人情	bu jin ren qing
不进则退	bu jin ze tui
不远万里	bu yuan wan li
不远千里	bu yuan qian li
不速之客	bu su zhi ke
不遗余力	bu yi yu li
不闻不问	bu wen bu wen
不露声色	bu lu sheng se
不露锋芒	bu lu feng mang
不顾一切	bu gu yi qie
不顾大局	bu gu da ju
不顾死活	bu gu si huo
不骄不躁	bu jiao bu zao
与世无争	yu shi wu zheng
与世长存	yu shi chang cun
与世长辞	yu shi chang ci
与世隔绝	yu shi ge jue
与人为善	yu ren wei shan
与人方便	yu ren fang bian
与众不同	yu zhong bu tong
与日俱增	yu ri ju zeng
与日俱进	yu ri ju jin
与时俱进	yu shi ju jin
与民同乐	yu min tong le
与虎添翼	yu hu tian yi
与虎谋皮	yu hu mou pi
丑态毕露	chou tai bi lu
丑态百出	chou tai bai chu
专心一意	zhuan xin yi yi
专心一致	zhuan xin yi zhi
专心致志	zhuan xin zhi zhi
专横跋扈	zhuan heng ba hu
专款专用	zhuan kuan zhuan yong
且战且退	qie zhan qie tui
世世代代	shi shi dai dai
世事炎凉	shi shi yan liang
世人皆知	shi ren jie zhi
世代相传	shi dai xiang chuan
世外桃源	shi wai tao yuan
世态炎凉	shi tai yan liang
世界大同	shi jie da tong
世风日下	shi feng ri xia
业精于勤	ye jing yu qin
丛山峻岭	cong shan jun ling
东倒西歪	dong dao xi wai
东奔西撞	dong ben xi zhuang
东奔西走	dong ben xi zou
东奔西跑	dong ben xi pao
东奔西逃	dong ben xi tao
东山再起	dong shan zai qi
东张西望	dong zhang xi wang
东征西讨	dong zheng xi tao
东拉西扯	dong la xi che
东拼西凑	dong pin xi cou
东挪西借	dong nuo xi jie
东挪西凑	dong nuo xi cou
东摇西摆	dong yao xi bai
东施效颦	dong shi xiao pin
东游西荡	dong you xi dang
东游西逛	dong you xi kuang
东碰西撞	dong peng xi zhuang
东窗事发	dong chuang shi fa
东藏西躲	dong cang xi duo
东补西凑	dong bu xi cou
东西南北	dong xi nan bei
东跑西奔	dong pao xi ben
东跑西颠	dong pao xi dian
东躲西藏	dong duo xi cang
东躲西跑	dong duo xi pao
东躲西逃	dong duo xi tao
东逃西窜	dong tao xi can
东郭先生	dong guo xian sheng
丝丝入扣	si si ru kou
丝毫不差	si hao bu cha
丢三拉四	diu san la si
丢三落四	diu san la si
丢人现眼	diu ren xian yan
丢卒保车	diu zu bao ju
丢盔卸甲	diu kui xie jia
丢盔弃甲	diu kui qi jia
丢车保帅	diu ju bao shuai
两全其美	liang quan qi mei
两厢情愿	liang xiang qing yuan
两小无猜	liang xiao wu cai
两手空空	liang shou kong kong
两极分化	liang ji fen hua
两相情愿	liang xiang qing yuan
两肋插刀	liang lei cha dao
两虎相争	liang hu xiang zheng
两虎相斗	liang hu xiang dou
两袖清风	liang xiu qing feng
两败俱伤	liang bai ju shang
两面三刀	liang mian san dao
两面讨好	liang mian tao hao
两鬓斑白	liang bin ban bai
严丝合缝	yan si he feng
严严实实	yan yan shi shi
严于律己	yan yu lu ji
严刑峻法	yan xing jun fa
严惩不贷	yan cheng bu dai
严父慈母	yan fu ci mu
严词拒绝	yan ci ju jue
严阵以待	yan zhen yi dai
丧家之犬	sang jia zhi quan
丧尽天良	sang jin tian liang
丧心病狂	sang xin bing kuang
丧权辱国	sang quan ru guo
丧魂落魄	sang hun luo po
个中滋味	ge zhong zi wei
个人主义	ge ren zhu yi
个人崇拜	ge ren chong bai
中庸之道	zhong yong zhi dao
中流砥柱	zhong liu di zhu
中西合璧	zhong xi he bi
中途而废	zhong tu er fei
中饱私囊	zhong bao si nang
丰功伟业	feng gong wei ye
丰功伟绩	feng gong wei ji
丰姿绰约	feng zi chuo yue
丰富多彩	feng fu duo cai
丰富多采	feng fu duo cai
丰衣足食	feng yi zu shi
串通一气	chuan tong yi qi
临别赠言	lin bie zeng yan
临危不乱	lin wei bu luan
临危不惧	lin wei bu ju
临危受命	lin wei shou ming
临时磨枪	lin shi mo qiang
临机应变	lin ji ying bian
临机立断	lin ji li duan
临渴掘井	lin ke jue jing
临阵磨刀	lin zhen mo dao
临阵磨枪	lin zhen mo qiang
临阵脱逃	lin zhen tuo tao
为之一振	wei zhi yi zhen
为人作嫁	wei ren zuo jia
为人师表	wei ren shi biao
为国为民	wei guo wei min
为国捐躯	wei guo juan qu
为富不仁	wei fu bu ren
为所欲为	wei suo yu wei
为时尚早	wei shi shang zao
为时过早	wei shi guo zao
为期不远	wei qi bu yuan
为民请命	wei min qing ming
为民除害	wei min chu hai
为虎作伥	wei hu zuo chang
为虎添翼	wei hu tian yi
为非作歹	wei fei zuo dai
主客颠倒	zhu ke dian dao
主次不分	zhu ci bu fen
举一反三	ju yi fan san
举不胜举	ju bu sheng ju
举世无双	ju shi wu shuang
举世无敌	ju shi wu di
举世皆知	ju shi jie zhi
举世瞩目	ju shi zhu mu
举世闻名	ju shi wen ming
举国一致	ju guo yi zhi
举国上下	ju guo shang xia
举手之劳	ju shou zhi lao
举手投足	ju shou tou zu
举棋不定	ju qi bu ding
举止大方	ju zhi da fang
举目无亲	ju mu wu qin
举足轻重	ju zu qing zhong
举重若轻	ju zhong ruo qing
久别重逢	jiu bie chong feng
久病成医	jiu bing cheng yi
久经考验	jiu jing kao yan
久经风霜	jiu jing feng shuang
久而久之	jiu er jiu zhi
久负盛名	jiu fu sheng ming
久闻大名	jiu wen da ming
义不容辞	yi bu rong ci
义愤填膺	yi fen tian ying
义无反顾	yi wu fan gu
义正词严	yi zheng ci yan
义正辞严	yi zheng ci yan
义气相投	yi qi xiang tou
义结金兰	yi jie jin lan
义薄云天	yi bo yun tian
乌七八糟	wu qi ba zao
乌合之众	wu he zhi zhong
乌烟瘴气	wu yan zhang qi
乍暖还寒	zha nuan hai han
乐不可支	le bu ke zhi
乐不思蜀	le bu si shu
乐于助人	le yu zhu ren
乐善好施	le shan hao shi
乐在其中	le zai qi zhong
乐极生悲	le ji sheng bei
乐此不倦	le ci bu juan
乐此不疲	le ci bu pi
乐而忘返	le er wang fan
乔装打扮	qiao zhuang da ban
乔迁之喜	qiao qian zhi xi
乘人之危	cheng ren zhi wei
乘兴而来	cheng xing er lai
乘其不备	cheng qi bu bei
乘机打劫	cheng ji da jie
乘胜追击	cheng sheng zhui ji
乘虚而入	cheng xu er ru
乘风破浪	cheng feng po lang
九九归一	jiu jiu gui yi
九死一生	jiu si yi sheng
九泉之下	jiu quan zhi xia
九牛一毛	jiu niu yi mao
九霄云外	jiu xiao yun wai
习以为常	xi yi wei chang
书声朗朗	shu sheng lang lang
书声琅琅	shu sheng lang lang
书香世家	shu xiang shi jia
书香门第	shu xiang men di
买椟还珠	mai du huan zhu
买空卖空	mai kong mai kong
乱七八糟	luan qi ba zao
乱作一团	luan zuo yi tuan
乱扣帽子	luan kou mao zi
乱点鸳鸯	luan dian yuan yang
乱臣贼子	luan chen zei zi
乳臭未干	ru xiu wei gan
了如指掌	liao ru zhi zhang
了然于心	liao ran yu xin
了然于胸	liao ran yu xiong
了若指掌	liao ruo zhi zhang
争先恐后	zheng xian kong hou
争分夺秒	zheng fen duo miao
争前恐后	zheng qian kong hou
争名夺利	zheng ming duo li
争名逐利	zheng ming zhu li
争奇斗艳	zheng qi dou yan
争妍斗艳	zheng yan dou yan
争强好胜	zheng qiang hao sheng
争权夺利	zheng quan duo li
争风吃醋	zheng feng chi cu
事不关己	shi bu guan ji
事不宜迟	shi bu yi chi
事不过三	shi bu guo san
事与愿违	shi yu yuan wei
事倍功半	shi bei gong ban
事关重大	shi guan zhong da
事出有因	shi chu you yin
事到临头	shi dao lin tou
事半功倍	shi ban gong bei
事在人为	shi zai ren wei
事必躬亲	shi bi gong qin
事无巨细	shi wu ju xi
事过境迁	shi guo jing qian
二话不说	er hua bu shuo
二话没说	er hua mei shuo
于事无补	yu shi wu bu
于心不忍	yu xin bu ren
于心何忍	yu xin he ren
于心无愧	yu jin wu kui
于心有愧	yu xin you kui
云开日出	yun kai ri chu
云开见日	yun kai jian ri
云开雾散	yun kai kai san
云泥之别	yun ni zhi bie
云消雾散	yun xiao wu san
云淡风轻	yun dan feng qing
云游四海	yun you si hai
云蒸霞蔚	yun zheng xia wei
互为因果	hu wei yin guo
互为表里	hu wei biao li
互相推诿	hu xiang tui wei
互相残杀	hu xiang can sha
互通有无	hu tong you wu
五体投地	wu ti tou di
五光十色	wu guang shi se
五内俱焚	wu nei ju fen
五内如焚	wu nei ru fen
五味俱全	wu wei ju quan
五大三粗	wu da san cu
五彩斑斓	wu cai ban lan
五彩缤纷	wu cai bin fen
五毒俱全	wu du ju quan
五洲四海	wu zhou si hai
五湖四海	wu hu si hai
五短身材	wu duan shen cai
五脏六腑	wu zang liu fu
五花八门	wu hua ba men
五花大绑	wu hua da bang
五讲四美	wu jiang si mei
五谷不分	wu gu bu fen
五谷丰登	wu gu feng deng
五雷轰顶	wu lei hong ding
五颜六色	wu yan liu se
井井有序	jing jing you xu
井井有条	jing jing you tiao
井底之蛙	jing di zhi wa
井底捞月	jing di lao yue
井然有序	jing ran you xu
井然有条	jing ran you tiao
井蛙之见	jing wa zhi jian
亡命之徒	wang ming zhi tu
亡羊补牢	wang yang bu lao
交口称赞	jiao kou cheng zan
交头接耳	jiao tou jie er
交浅言深	jiao qian yan shen
交相辉映	jiao xiang hui ying
亦步亦趋	yi bu yi qu
亭亭玉立	ting ting yu li
亭台楼阁	ting tai lou ge
亲力亲为	qin li qin wei
亲如一家	qin ru yi jia
亲如兄弟	qin ru xiong di
亲如手足	qin ru shou zu
亲密无间	qin mi wu jian
亲戚朋友	qin qi peng you
亲痛仇快	qin tong chou kuai
人丁兴旺	ren ding xing wang
人之常情	ren zhi chang qing
人云亦云	ren yun yi yun
人人皆知	ren ren jie zhi
人人自危	ren ren zi wei
人以群分	ren yi qun fen
人仰马翻	ren yang ma fan
人去楼空	ren qu lou kong
人各有志	ren ge you zhi
人命关天	ren ming guan tian
人困马乏	ren kun ma fa
人声鼎沸	ren sheng ding fei
人多势众	ren duo shi zhong
人多嘴杂	ren duo zui za
人多手杂	ren duo shou za
人定胜天	ren ding sheng tian
人小鬼大	ren xiao gui da
人尽其才	ren jin qi cai
人山人海	ren shan ren hai
人微言轻	ren wei yan qing
人心叵测	ren xin po ce
人心向背	ren xin xiang bei
人心惶惶	ren xin huang huang
人心所向	ren xin suo xiang
人心涣散	ren xin huan san
人心难测	ren xin nan ce
人情世故	ren qing shi gu
人情冷暖	ren qing leng nuan
人所共知	ren suo gong zhi
人手一册	ren shou yi ce
人才济济	ren cai ji ji
人才辈出	ren cai bei chu
人才难得	ren cai cai de
人无完人	ren wu wan ren
人来人往	ren lai ren wang
人杰地灵	ren jie di ling
人模人样	ren mo ren yang
人模狗样	ren mu gou yang
人浮于事	ren fu yu shi
人海战术	ren hai zhan shu
人满为患	ren man wei huan
人烟稀少	ren yan xi shao
人烟稠密	ren yan chou mi
人生如梦	ren sheng ru meng
人神共愤	ren shen gong fen
人穷志短	ren qiong zhi duan
人老珠黄	ren lao zhu huang
人言可畏	ren yan ke wei
人财两空	ren cai liang kong
人赃俱获	ren zang ju huo
人赃并获	ren zang bing huo
人迹罕至	ren ji han zhi
人道主义	ren dao zhu yi
人间地狱	ren jian di yu
人间天堂	ren jian tian tang
人非草木	ren fei cao mu
人面兽心	ren mian shou xin
人面桃花	ren mian tao hua
仁义道德	ren yi dao de
仁人志士	ren ren zhi shi
仁至义尽	ren zhi yi jin
仅此而已	jin ci er yi
今不如昔	jin bu ru xi
今非昔比	jin fei xi bi
从一而终	cong yi er zhong
从中作梗	cong zhong zuo geng
从中斡旋	cong zhong wo xuan
从中渔利	cong zhong yu li
从何说起	cong he shuo qi
从善如流	cong shan ru liu
从天而降	cong tian er jiang
从头做起	cong tou zuo qi
从头到尾	cong tou dao wei
从头至尾	cong tou zhi wei
从容不迫	cong rong bu po
从容应对	cong rong ying dui
从容自如	cong rong zi ru
从容自若	cong rong zi ruo
从宽发落	cong kuan fa luo
从轻发落	cong qing fa luo
从长计议	cong chang ji yi
仓皇出逃	cang huang chu tao
仓皇失措	cang huang shi cuo
他山之石	ta shan zhi shi
仗义执言	zhang yi zhi yan
仗义疏财	zhang yi shu cai
仗势欺人	zhang shi qi ren
付之一炬	fu zhi yi ju
付之一笑	fu zhi yi xiao
付之东流	fu zhi dong liu
付诸一炬	fu zhu yi ju
付诸东流	fu zhu dong liu
代人受过	dai ren shou guo
代代相传	dai dai xiang chuan
令人作呕	ling ren zuo ou
令人发指	ling ren fa zhi
令人吃惊	ling ren chi jing
令人喷饭	ling ren pen fan
令人寒心	ling ren han xin
令人捧腹	ling ren peng fu
令人注目	ling ren zhu mu
令人满意	ling ren man yi
令人生畏	ling ren sheng wei
令人痛心	ling ren tong xin
令人瞩目	ling ren zhu mu
令人神往	ling ren shen wang
令人羡慕	ling ren xian mu
令人钦佩	ling ren qin pei
令行禁止	ling xing jin zhi
以一当十	yi yi dang shi
以一当百	yi yi dang bai
以人为本	yi ren wei ben
以人为镜	yi ren wei jing
以假乱真	yi jia luan zhen
以偏概全	yi pian gai quan
以势压人	yi shi ya ren
以勤补拙	yi qin bu zhuo
以卵击石	yi luan ji shi
以卵投石	yi luan tou shi
以备万一	yi bei wan yi
以大欺小	yi da qi xiao
以守为攻	yi shou wei gong
以寡敌众	yi gua di zhong
以小见大	yi xiao jian da
以少胜多	yi shao sheng duo
以己度人	yi ji duo ren
以弱胜强	yi ruo sheng qiang
以强凌弱	yi qiang ling ruo
以强欺弱	yi qiang qi ruo
以德报德	yi de bao yu
以德报怨	yi de bao yuan
以德服人	yi de fu ren
以怨报德	yi yuan bao de
以攻为守	yi gong wei shou
以权谋私	yi quan mou si
以柔克刚	yi rou ke gang
以正视听	yi zheng shi ting
以此类推	yi ci lei tui
以毒攻毒	yi du gong du
以点带面	yi dian dai mian
以牙还牙	yi ya huan ya
以理服人	yi li fu ren
以眼还眼	yi yan huan yan
以礼相待	yi li xiang dai
以管窥豹	yi guan kui bao
以绝后患	yi jue hou huan
以观后效	yi guan hou xiao
以讹传讹	yi e chuan e
以貌取人	yi mao qu ren
以身作则	yi shen zuo ze
以身殉国	yi sheng xun guo
以身殉职	yi shen xun zhi
以身试法	yi shen shi fa
以身试险	yi shen shi xian
以退为进	yi tui wei jin
以逸待劳	yi yi dai lao
以邻为壑	yi lin wei he
以防万一	yi fang wan yi
以防不测	yi fang bu ce
以防未然	yi fang wei ran
仪态万千	yi tai wan qian
仪表堂堂	yi biao tang tang
仰人鼻息	yang ren bi xi
仰天大笑	yang tian da xiao
仰面朝天	yang mian chao tian
价值连城	jia zhi lian cheng
价廉物美	jia lian wu mei
任人唯亲	ren ren wei qin
任人唯贤	ren ren wei xian
任人宰割	ren ren zai ge
任人摆布	ren ren bai bu
任劳任怨	ren lao ren yuan
任怨任劳	ren yuan ren lao
任重道远	ren zhong dao yuan
休养生息	xiu yang sheng xi
休戚与共	xiu qi yu gong
休戚相关	xiu qi xiang guan
众叛亲离	zhong pan qin li
众口一词	zhong kou yi ci
众口同声	zhong kou tong sheng
众口纷纭	zhong kou fen yun
众口难调	zhong kou nan tiao
众志成城	zhong zhi cheng cheng
众怒难犯	zhong nu nan fan
众所共知	zhong suo gong zhi
众所周知	zhong suo zhou zhi
众所瞩目	zhong suo zhu mu
众星拱月	zhong xing gong yue
众星捧月	zhong xing peng yue
众望所归	zhong wang suo gui
众目共睹	zhong mu gong du
众目睽睽	zhong mu kui kui
众矢之的	zhong shi zhi di
众说纷纭	zhong shuo fen yun
优哉游哉	you zai you zai
优柔寡断	you rou gua duan
优胜劣败	you sheng lie bai
会心一笑	hui xin yi xiao
传为佳话	chuan wei jia hua
传为笑柄	chuan wei xiao bing
传为笑谈	chuan wei xiao tan
传为美谈	chuan wei mei tan
传宗接代	chuan zong jie dai
传道授业	chuan dao shou ye
伤天害理	shang tian hai li
伤筋动骨	shang jin dong gu
伤风败俗	shang feng bai su
伯乐相马	bo le xiang ma
伯仲之间	bo zhong zhi jian
伶牙俐齿	ling ya li chi
伶牙利齿	ling ya li chi
似懂非懂	si dong fei dong
似是而非	si shi er fei
似曾相识	si ceng xiang shi
似笑非笑	si xiao fei xiao
低三下四	di san xia si
低人一等	di ren yi deng
低声下气	di sheng xia qi
低声细语	di sheng xi yu
低头丧气	di tou sang qi
低头哈腰	di tou ha yao
低头认罪	di tou ren zui
低眉顺眼	di mei shun yan
体察民情	ti cha min qing
体无完肤	ti wu wan fu
体贴入微	ti tie ru wei
何乐不为	he le bu wei
何去何从	he qu he cong
何必当初	he bi dang chu
余味无穷	yu wei wu qiong
余音绕梁	yu yin rao liang
余音缭绕	yu yin liao rao
余音袅袅	yu yin niao niao
佛口蛇心	fo kou she xin
作壁上观	zuo bi shang guan
作奸犯科	zuo jian fan ke
作威作福	zuo wei zuo fu
作恶多端	zuo e duo duan
作法自毙	zuo fa zi bi
作茧自缚	zuo jian zi fu
作贼心虚	zuo zei xin xu
你争我夺	ni zheng wo duo
你来我往	ni lai wo wang
你死我活	ni si wo huo
你追我赶	ni zhui wo gan
侃侃而谈	kan kan er tan
例行公事	li xing gong shi
供不应求	gong bu ying qiu
供认不讳	gong ren bu hui
供过于求	gong guo yu qiu
依依不舍	yi yi bu she
依依惜别	yi yi xi bie
依山傍水	yi shan bang shui
依此类推	yi ci lei tui
依然如故	yi ran ru gu
依然故我	yi ran gu wo
侠肝义胆	xia gan yi dan
侧目而视	ce mu er shi
便宜行事	bian yi xing shi
促膝谈心	cu xi tan xin
俗不可耐	su bu ke nai
保家卫国	bao jia wei guo
信以为真	xin yi wei zhen
信口开河	xin kou kai he
信口胡言	xin kou hu yan
信口胡说	xin kou hu shuo
信口雌黄	xin kou ci huang
信心十足	xin xin shi zu
信手拈来	xin shou nian lai
信誓旦旦	xin shi dan dan
信马由缰	xin ma you jiang
修修补补	xiu xiu bu bu
修心养性	xiu xin yang xing
修身养性	xiu shen yang xing
俯拾即是	fu shi ji shi
俯拾皆是	fu shi jie shi
俯首听命	fu shou ting ming
俯首帖耳	fu shou tie er
俯首贴耳	fu shou tie er
倒打一耙	dao da yi pa
倒背如流	dao bei ru liu
倒行逆施	dao xing ni shi
倚势欺人	yi shi qi ren
倚强凌弱	yi qiang ling ruo
倚老卖老	yi lao mai lao
借刀杀人	jie dao sha ren
借古喻今	jie gu yu jin
借古讽今	jie gu feng jin
借坡下驴	jie po xia lu
借尸还魂	jie shi huan hun
借故推辞	jie gu tui ci
借花献佛	jie hua xian fo
借酒浇愁	jie jiu jiao chou
借题发挥	jie ti fa hui
债台高筑	zhai tai gao zhu
倾囊相助	qing nang xiang zhu
倾国倾城	qing guo qing cheng
倾家荡产	qing jia dang chan
倾巢出动	qing chao chu dong
倾巢而出	qing chao er chu
倾注全力	qing zhu quan li
倾盆大雨	qing pen da yu
偃旗息鼓	yan qi xi gu
假仁假义	jia ren jia yi
假公济私	jia gong ji si
假戏真做	jia xi zhen zuo
偏听偏信	pian ting piang xin
做贼心虚	zuo zei xin xu
停滞不前	ting zhi bu qian
健步如飞	jian bu ru fei
偶一为之	ou yi wei zhi
偷偷摸摸	tou tou mo mo
偷天换日	tou tian huan ri
偷工减料	tou gong jian liao
偷梁换柱	tou liang huan zhu
偷鸡摸狗	tou ji mo gou
催人泪下	cui ren lei xia
傲慢不逊	ao man bu xun
傲慢无礼	ao man wu li
傲然屹立	ao ran yi li
傲然挺立	ao ran ting li
傻里傻气	sha li sha qi
像模像样	xiang mo xiang yang
僧多粥少	seng duo zhou shao
儿女情长	er nu qing chang
充耳不闻	chong er bu wen
先人后己	xian ren hou ji
先入为主	xian ru wei zhu
先入之见	xian ru zhi jian
先发制人	xian fa zhi ren
先声夺人	xian sheng duo ren
先天不足	xian tian bu zu
先斩后奏	xian zhan hou zou
先来后到	xian lai hou dao
先睹为快	xian du wei kuai
先知先觉	xian zhi xian jue
先礼后兵	xian li hou bing
先苦后甜	xian ku hou tian
先见之明	xian jian zhi ming
光天化日	guang tian hua ri
光宗耀祖	guang zong yao zu
光彩夺目	guang cai duo mu
光怪陆离	guang guai lu li
光明大道	guang ming da dao
光明正大	guang ming zheng da
光明磊落	guang ming lei luo
光芒万丈	guang mang wan zhang
光芒四射	guang mang si she
光说不练	guang shuo bu lian
光辉灿烂	guang hui can lan
光阴似箭	guang yin si jian
光阴如箭	guang yin ru jian
光阴荏苒	guang yin ren ran
克勤克俭	ke qin ke jian
克己奉公	ke ji feng gong
克敌制胜	ke di zhi sheng
兔死狐悲	tu si hu bei
兔死狗烹	tu si gou peng
党同伐异	dang tong fa yi
兢兢业业	jing jing ye ye
入不敷出	ru bu fu chu
入乡问俗	ru xiang wen su
入乡随俗	ru xiang sui su
入土为安	ru tu wei an
入情入理	ru qing ru li
入木三分	ru mu san fen
全军覆没	quan jun fu mo
全军覆灭	quan jun fu mie
全力以赴	quan li yi fu
全心全意	quan xin quan yi
全盘托出	quan pan tuo chu
全神贯注	quan shen guan zhu
八仙过海	ba xian guo hai
八拜之交	ba bai zhi jiao
八方呼应	ba fang hu ying
八方支援	ba fang zhi yuan
八面威风	ba mian wei feng
八面玲珑	ba mian ling long
公之于众	gong zhi yu zhong
公事公办	gong shi gong ban
公子哥儿	gong zi ge er
公平交易	gong ping jiao yi
公平合理	gong ping he li
公平无私	gong ping wu si
公平正直	gong ping zheng zhi
公报私仇	gong bao si chou
公正不阿	gong zheng bu e
公正严明	gong zheng yan ming
公正廉明	gong zheng lian ming
公正廉洁	gong zheng lian jie
公正无私	gong zheng wu si
公私兼顾	gong si jian gu
公私分明	gong si fen ming
公而忘私	gong er wang si
公诸于世	gong zhu yu shi
六亲不认	liu qin bu ren
六根清净	liu gen qing jing
六畜兴旺	liu chu xing wang
六神无主	liu shen wu zhu
关怀备至	guan huai bei zhi
关门大吉	guan men da ji
兴利除弊	xing li chu bi
兴味索然	xing wei suo ran
兴妖作怪	xing yao zuo guai
兴家立业	xing jia li ye
兴师动众	xing shi dong zhong
兴师问罪	xing shi wen zui
兴旺发达	xing wang fa da
兴致勃勃	xing zhi bo bo
兴致索然	xing zhi suo ran
兴趣盎然	xing qu ang ran
兴风作浪	xing feng zuo lang
兴高采烈	xing gao cai lie
兵不厌诈	bing bu yan zha
兵不血刃	bing bu xue ren
兵临城下	bing lin cheng xia
兵多将广	bing duo jiang guang
兵强马壮	bing qiang ma zhuang
兵戎相见	bing rong xiang jian
兵荒马乱	bing huang ma luan
兵贵神速	bing gui shen su
其乐无穷	qi le wu qiong
其乐融融	qi le rong rong
其味无穷	qi wei wu qiong
其貌不扬	qi mao bu yang
养儿防老	yang er fang lao
养家糊口	yang jia hu kou
养尊处优	yang zun chu you
养生之道	yang sheng zhi dao
养精蓄锐	yang jing xu rui
养老送终	yang lao song zhong
养虎为患	yang hu wei huan
养虎遗患	yang hu yi huan
兼容并包	jian rong bing bao
兼容并蓄	jian rong bing xu
兼收并蓄	jian shou bing xu
兼而有之	jian er you zhi
内外交困	nei wai jiao kun
内外勾结	nei wai gou jie
内外夹击	nei wai jia ji
内外夹攻	nei wai jia gong
内外有别	nei wai you bie
内忧外患	nei you wai huan
再三再四	zai san zai si
再接再厉	zai jie zai li
再生父母	zai sheng fu mu
冒冒失失	mao mao shi shi
冒名顶替	mao ming ding ti
军令如山	jun ling ru shan
冠冕堂皇	guan mian tang huang
冠盖云集	guan gai yun ji
冤假错案	yuan jia cuo an
冤冤相报	yuan yuan xiang bao
冤家对头	yuan jia dui tou
冤家路窄	yuan jia lu zhai
冥思苦想	ming si ku xiang
冥顽不化	ming wan bu hua
冥顽不灵	ming wan bu ling
冰天雪地	bing tian xue di
冰山一角	bing shan yi jiao
冰消瓦解	bing xiao wa jie
冰清玉洁	bing qing yu jie
冰雪聪明	bing xue cong ming
冲口而出	chong kou er chu
冲昏头脑	chong hun tou nao
冲锋陷阵	chong feng xian zhen
决一死战	jue yi si zhan
决一胜负	jue yi sheng fu
决胜千里	jue sheng qian li
冷冷清清	leng leng qing qing
冷嘲热讽	leng chao re feng
冷暖自知	leng nuan zi zhi
冷眼旁观	leng yan pang guan
冷眼相待	leng yan xiang dai
冷若冰霜	leng ruo bing shuang
冷血动物	leng xue dong wu
冷言冷语	leng yan leng yu
冷酷无情	leng ku wu qing
凄风苦雨	qi feng ku yu
凉了半截	liang le ban jie
凛然正气	lin ran zheng qi
几次三番	ji ci san fan
凡夫俗子	fan fu su zi
凤毛麟角	feng mao lin jiao
凭空捏造	ping kong nie zao
凯旋而归	kai xuan er gui
凶多吉少	xiong duo ji shao
凶相毕露	xiong xiang bi lu
凶神恶煞	xiong shen e sha
凹凸不平	ao tu bu ping
出乎意外	chu hu yi wai
出乎意料	chu hu yi liao
出乎预料	chu hu yu liao
出于无奈	chu yu wu nai
出人头地	chu ren tou di
出人意外	chu ren yi wai
出人意料	chu ren yi liao
出其不意	chu qi bu yi
出口伤人	chu kou shang ren
出口成章	chu kou cheng zhang
出头之日	chu tou zhi ri
出头露面	chu tou lu mian
出奇制胜	chu qi zhi sheng
出尔反尔	chu er fan er
出师不利	chu shi bu li
出水芙蓉	chu shui fu rong
出没无常	chu mo wu chang
出生入死	chu sheng ru si
出神入化	chu shen ru hua
出类拔萃	chu lei ba cui
出言不逊	chu yan bu xun
出谋划策	chu mou hua ce
出谋献策	chu mou xian ce
击中要害	ji zhong yao hai
凿壁借光	zao bi jie guang
凿壁偷光	zao bi tou guang
刀下留人	dao xia liu ren
刀光剑影	dao guang jian ying
刀光血影	dao guang xue ying
刀山火海	dao shan huo hai
刀枪不入	dao qiang bu ru
刀枪入库	dao qiang ru ku
刀耕火种	dao geng huo zhong
刁钻古怪	diao zuan gu guai
分一杯羹	fen yi bei geng
分内之事	fen nei zhi shi
分化瓦解	fen hua wa jie
分崩离析	fen beng li xi
分工合作	fen gong he zuo
分庭抗礼	fen ting kang li
分文不值	fen wen bu zhi
分文不取	fen wen bu qu
分毫不差	fen hao bu cha
分秒必争	fen miao bi zheng
分而治之	fen er zhi zhi
分道扬镳	fen dao yang biao
分门别类	fen men bie lei
切中时弊	qie zhong shi bi
切中要害	qie zhong yao hai
切合实际	qie he shi ji
切肤之痛	qie fu zhi tong
切身体会	qie shen ti hui
切齿痛恨	qie chi tong hen
刎颈之交	wen jing zhi jiao
刚愎自用	gang bi zi yong
刚柔相济	gang rou xiang ji
刚正不阿	gang zheng bu e
刚正无私	gang zheng wu si
刚直不阿	gang zhi bu e
初出茅庐	chu chu mao lu
初来乍到	chu lai zha dao
初生之犊	chu sheng zhi du
初露头角	chu lu tou jiao
初露锋芒	chu lu feng mang
删繁就简	shan fan jiu jian
判若两人	pan ruo liang ren
刨根究底	pao gen jiu di
刨根问底	pao gen wen di
利令智昏	li ling zhi hun
利害攸关	li hai you guan
利害相关	li hai xiang guan
利欲熏心	li yu xun xin
别具一格	bie ju yi ge
别具匠心	bie ju jiang xin
别具慧眼	bie ju hui yan
别出心裁	bie chu xin cai
别出新意	bie chu xin yi
别别扭扭	bie bie niu niu
别开生面	bie kai sheng mian
别无二致	bie wu er zhi
别无出路	bie wu chu lu
别无所求	bie wu suo qiu
别无选择	bie wu xuan ze
别有企图	bie you qi tu
别有天地	bie you tian di
别有洞天	bie you dong tian
别有用心	bie you yong xin
别有风味	bie you feng wei
别来无恙	bie lai wu yang
别树一帜	bie shu yi zhi
刮目相待	gua mu xiang dai
刮目相看	gua mu xiang kan
到处碰壁	dao chu peng bi
到此为止	dao ci wei zhi
刻不容缓	ke bu rong huan
刻画入微	ke hua ru wei
刻舟求剑	ke zhou qiu jian
刻苦耐劳	ke ku nai lao
刻苦钻研	ke ku zuan yan
刻骨仇恨	ke gu chou hen
刻骨铭心	ke gu ming xin
削足适履	xue zu shi lu
前仆后继	qian pu hou ji
前仰后合	qian yang hou he
前俯后仰	qian fu hou yang
前倨后恭	qian ju hou gong
前前后后	qian qian hou hou
前功尽弃	qian gong jin qi
前呼后应	qian hu hou ying
前呼后拥	qian hu hou yong
前因后果	qian yin hou guo
前思后想	qian si hou xiang
前所未有	qian suo wei you
前所未闻	qian suo wei wen
前无古人	qian wu gu ren
前程万里	qian cheng wan li
前程似锦	qian cheng si jin
前程远大	qian cheng yuan da
前赴后继	qian fu hou ji
前车之鉴	qian che zhi jian
前车可鉴	qian che ke jian
前途未卜	qian tu wei bu
前途渺茫	qian tu miao mang
剑拔弩张	jian ba nu zhang
剥茧抽丝	bo jian chou si
剪草除根	jian cao chu gen
割据一方	ge ju yi fang
劈头盖脑	pi tou gai nao
劈头盖脸	pi tou gai lian
劈荆斩棘	pi jing zhan ji
劈里啪啦	pi li pa la
力不从心	li bu cong xin
力不能及	li bu neng ji
力不能支	li bu neng zhi
力争上游	li zheng shang you
力大无穷	li da wu qiong
力所不及	li suo bu ji
力所能及	li suo neng ji
力挽狂澜	li wan kuang lan
力排众议	li pai zhong yi
力竭声嘶	li jie sheng si
力透纸背	li tou zhi bei
劝善惩恶	quan shan cheng e
功亏一篑	gong kui yi kui
功名利禄	gong ming li lu
功德圆满	gong de yuan man
功德无量	gong de wu liang
功成名就	gong cheng ming jiu
功成身退	gong cheng shen tui
功败垂成	gong bai chui cheng
功过是非	gong guo shi fei
功高盖世	gong gao gai shi
功高震主	gong gao zhen zhu
加油添醋	jia you tian cu
劣迹昭著	lie ji zhao zhu
动之以情	dong zhi yi qing
动人心弦	dong ren xin xian
动人心魄	dong ren xin po
动如脱兔	dong ru tuo tu
动手动脚	dong shou dong jiao
动荡不安	dong dang bu an
动荡不定	dong dang bu ding
动辄得咎	dong zhe de jiu
动魄惊心	dong po jing xin
助人为乐	zhu ren wei le
助纣为虐	zhu zhou wei nue
劫后余生	jie hou yu sheng
劫富济贫	jie fu ji pin
励精图治	li jing tu zhi
劳师动众	lao shi dong zhong
劳民伤财	lao min shang cai
劳燕分飞	lao yan fen fei
劳而无功	lao er wu gong
劳苦功高	lao ku gong gao
劳逸结合	lao yi jie he
势不两立	shi bu liang li
势不可当	shi bu ke dang
势不可挡	shi bu ke dang
势不容缓	shi bu rong huan
势在必行	shi zai bi xing
势均力敌	shi jun li di
势如水火	shi ru shui huo
势如破竹	shi ru po zhu
勃然变色	bo ran bian se
勃然大怒	bo ran da nu
勇往直前	yong wang zhi qian
勇猛果敢	yong meng guo gan
勉为其难	mian wei qi nan
勤俭持家	qin jian chi jia
勤俭节约	qin jian jie yue
勤劳勇敢	qin lao yong gan
勤勤恳恳	qin qin ken ken
勤学好问	qin xue hao wen
勤学苦练	qin xue ku zh
勤工俭学	qin gong jian xue
勤能补拙	qin neng bu zhuo
勾心斗角	gou xin dou jiao
勾肩搭背	gou jian da bei
包办代替	bao ban dai ti
包罗万象	bao luo wan xiang
包藏祸心	bao cang huo xin
匆匆忙忙	cong cong mang mang
化为乌有	hua wei wu you
化为泡影	hua wei pao ying
化为灰烬	hua wei hui jin
化敌为友	hua di wei you
化整为零	hua zheng wei ling
化险为夷	hua xian wei yi
化零为整	hua ling wei zheng
匠心独具	jiang xin du ju
匠心独运	jiang xin du yun
匪夷所思	fei yi suo si
匹夫之勇	pi fu zhi yong
匹夫有责	pi fu you ze
区区小事	qu qu xiao shi
十万火急	shi wan huo ji
十之八九	shi zhi ba jiu
十全十美	shi quan shi mei
十字街头	shi zi jie tou
十字路口	shi zi lu kou
十室九空	shi shi jiu kong
十年寒窗	shi nian han chuang
十恶不赦	shi e bu she
十拿九稳	shi na jiu wen
十指连心	shi zhi lian xin
十有八九	shi you ba jiu
十面埋伏	shi mian mai fu
千丝万缕	qian si wan lu
千人一面	qian ren yi mian
千依百顺	qian yi bai shun
千军万马	qian jun wan ma
千千万万	qian qian wan wan
千变万化	qian bian wan hua
千古奇闻	qian gu qi wen
千古罪人	qian gu zui ren
千叮万嘱	qian ding wan zhu
千呼万唤	qian hu wan huan
千回百转	qian hui bai zhuan
千夫所指	qian fu suo zhi
千头万绪	qian tou wan xu
千奇百怪	qian qi bai guai
千姿百态	qian zi bai tai
千娇百媚	qian jiao bai mei
千家万户	qian jia wan hu
千山万水	qian shan wan shui
千差万别	qian cha wan bie
千恩万谢	qian en wan xie
千方百计	qian fang bai ji
千条万缕	qian tiao wan lu
千疮百孔	qian chuang bai kong
千真万确	qian zhen wan que
千秋万代	qian qiu wan dai
千秋大业	qian qiu da ye
千篇一律	qian pian yi lu
千言万语	qian yan wan yu
千载一遇	qian zai yi yu
千载难逢	qian zai nan feng
千载难遇	qian zai nan yu
千辛万苦	qian xin wan ku
到处碰壁	dao chu peng bi
到此为止	dao ci wei zhi
刻不容缓	ke bu rong huan
刻画入微	ke hua ru wei
刻舟求剑	ke zhou qiu jian
刻船求剑	ke chuan qiu jian
刻苦耐劳	ke ku nai lao
刻苦钻研	ke ku zuan yan
刻骨仇恨	ke gu chou hen
刻骨铭心	ke gu ming xin
削尖脑袋	xiao jian nao dai
削足适履	xue zu shi lu
前仆后继	qian pu hou ji
前仰后合	qian yang hou he
前俯后仰	qian fu hou yang
前倨后恭	qian ju hou gong
前前后后	qian qian hou hou
前功尽弃	qian gong jin qi
前呼后应	qian hu hou ying
前呼后拥	qian hu hou yong
前因后果	qian yin hou guo
前思后想	qian si hou xiang
前所未有	qian suo wei you
前所未闻	qian suo wei wen
前无古人	qian wu gu ren
前程万里	qian cheng wan li
前程似锦	qian cheng si jin
前程远大	qian cheng yuan da
前赴后继	qian fu hou ji
前车之鉴	qian che zhi jian
前车可鉴	qian che ke jian
前途未卜	qian tu wei bu
前途渺茫	qian tu miao mang
剑拔弩张	jian ba nu zhang
剥茧抽丝	bo jian chou si
剪草除根	jian cao chu gen
割据一方	ge ju yi fang
劈天盖地	pi tian gai di
劈头盖脸	pi tou gai lian
劈荆斩棘	pi jing zhan ji
劈里啪啦	pi li pa la
力不从心	li bu cong xin
力不胜任	li bu sheng ren
力不能及	li bu neng ji
力不能支	li bu neng zhi
力争上游	li zheng shang you
力大无穷	li da wu qiong
力尽筋疲	li jin jin pi
力所不及	li suo bu ji
力所能及	li suo neng ji
力挽狂澜	li wan kuang lan
力排众议	li pai zhong yi
力透纸背	li tou zhi bei
劝善惩恶	quan shan cheng e
功亏一篑	gong kui yi kui
功名利禄	gong ming li lu
功德圆满	gong de yuan man
功德无量	gong de wu liang
功成名就	gong cheng ming jiu
功成身退	gong cheng shen tui
功败垂成	gong bai chui cheng
功过是非	gong guo shi fei
功高盖世	gong gao gai shi
功高震主	gong gao zhen zhu
加减乘除	jia jian cheng chu
加油添醋	jia you tian cu
劣迹昭著	lie ji zhao zhu
动之以情	dong zhi yi qing
动人心弦	dong ren xin xian
动人心魄	dong ren xin po
动如脱兔	dong ru tuo tu
动手动脚	dong shou dong jiao
动荡不安	dong dang bu an
动荡不定	dong dang bu ding
动辄得咎	dong zhe de jiu
动魄惊心	dong po jing xin
助人为乐	zhu ren wei le
助纣为虐	zhu zhou wei nue
劫后余生	jie hou yu sheng
劫富济贫	jie fu ji pin
励精图治	li jing tu zhi
劳师动众	lao shi dong zhong
劳民伤财	lao min shang cai
劳燕分飞	lao yan fen fei
劳而无功	lao er wu gong
劳苦功高	lao ku gong gao
劳逸结合	lao yi jie he
势不两立	shi bu liang li
势不可当	shi bu ke dang
势不可挡	shi bu ke dang
势不容缓	shi bu rong huan
势在必行	shi zai bi xing
势均力敌	shi jun li di
势如水火	shi ru shui huo
势如破竹	shi ru po zhu
勃然变色	bo ran bian se
勃然大怒	bo ran da nu
勇往直前	yong wang zhi qian
勇猛果敢	yong meng guo gan
勉为其难	mian wei qi nan
勤俭持家	qin jian chi jia
勤俭节约	qin jian jie yue
勤劳勇敢	qin lao yong gan
勤勤恳恳	qin qin ken ken
勤学好问	qin xue hao wen
勤学苦练	qin xue ku zh
勤工俭学	qin gong jian xue
勤能补拙	qin neng bu zhuo
勾心斗角	gou xin dou jiao
勾肩搭背	gou jian da bei
包办代替	bao ban dai ti
包罗万象	bao luo wan xiang
包藏祸心	bao cang huo xin
匆匆忙忙	cong cong mang mang
化为乌有	hua wei wu you
化为泡影	hua wei pao ying
化为灰烬	hua wei hui jin
化敌为友	hua di wei you
化整为零	hua zheng wei ling
化险为夷	hua xian wei yi
化零为整	hua ling wei zheng
匠心独具	jiang xin du ju
匠心独运	jiang xin du yun
匪夷所思	fei yi suo si
匹夫之勇	pi fu zhi yong
匹夫有责	pi fu you ze
区区小事	qu qu xiao shi
十万火急	shi wan huo ji
十之八九	shi zhi ba jiu
十全十美	shi quan shi mei
十字街头	shi zi jie tou
十字路口	shi zi lu kou
十室九空	shi shi jiu kong
十年寒窗	shi nian han chuang
十恶不赦	shi e bu she
十拿九稳	shi na jiu wen
十指连心	shi zhi lian xin
十月怀胎	shi yue huai tai
十有八九	shi you ba jiu
十面埋伏	shi mian mai fu
千丝万缕	qian si wan lu
千人一面	qian ren yi mian
千军万马	qian jun wan ma
千千万万	qian qian wan wan
千变万化	qian bian wan hua
千古奇闻	qian gu qi wen
千古罪人	qian gu zui ren
千叮万嘱	qian ding wan zhu
千呼万唤	qian hu wan huan
千回百转	qian hui bai zhuan
千夫所指	qian fu suo zhi
千头万绪	qian tou wan xu
千奇百怪	qian qi bai guai
千姿百态	qian zi bai tai
千娇百媚	qian jiao bai mei
千家万户	qian jia wan hu
千山万水	qian shan wan shui
千差万别	qian cha wan bie
千恩万谢	qian en wan xie
千斤重担	qian jin zhong dan
千方百计	qian fang bai ji
千条万缕	qian tiao wan lu
千疮百孔	qian chuang bai kong
千真万确	qian zhen wan que
千秋万代	qian qiu wan dai
千秋大业	qian qiu da ye
千篇一律	qian pian yi lu
千言万语	qian yan wan yu
千载一遇	qian zai yi yu
千载难逢	qian zai nan feng
千载难遇	qian zai nan yu
千辛万苦	qian xin wan ku
千里迢迢	qian li tiao tiao
千金不换	qian jin bu huan
千金小姐	qian jin xiao jie
千金难买	qian jin nan mai
千钧一发	qian jun yi fa
千钧重负	qian jun zhong fu
千锤百炼	qian chui bai lian
千难万险	qian nan wan xian
升官发财	sheng guan fa cai
半信半疑	ban xin ban yi
半吞半吐	ban tun ban tu
半壁江山	ban bi jiang shan
半夜三更	ban ye san geng
半工半读	ban gong ban du
半懂不懂	ban dong bu dong
半推半就	ban tui ban jiu
半斤八两	ban jin ba liang
半梦半醒	ban meng ban xing
半死不活	ban si bu huo
半瓶子醋	ban ping zi cu
半生不熟	ban sheng bu shu
半真半假	ban zhen ban jia
半老徐娘	ban lao xu niang
半路出家	ban lu chu jia
半身不遂	ban shen bu sui
半途而废	ban tu er fei
华而不实	hua er bu shi
卑躬屈膝	bei gong qu xi
卑鄙无耻	bei bi wu chi
卑鄙龌龊	bei bi wo chuo
卓尔不群	zhuo er bu qun
卓有成效	zhuo you cheng xiao
单刀直入	dan dao zhi ru
单刀赴会	dan dao fu hui
单枪匹马	dan qiang pi ma
卖友求荣	mai you qiu rong
卖国求荣	mai guo qiu rong
卖弄学问	mai nong xue wen
卖弄风情	mai nong feng qing
卖弄风骚	mai nong feng sao
卖身投靠	mai shen tou kao
南征北战	nan zheng bei zhan
南来北往	nan lai bei wang
南柯一梦	nan ke yi meng
南腔北调	nan qiang bei diao
南辕北辙	nan yuan bei zhe
博古通今	bo gu tong jin
博大精深	bo da jing shen
博学多才	bo xue duo cai
博学多闻	bo xue duo wen
博而不精	bo er bu jing
博览群书	bo lan qun shu
博采众长	bo cai zhong chang
博闻强记	bo wen qiang ji
博闻强识	bo wen qiang zhi
占为己有	zhan wei ji you
卧床不起	wo chuang bu qi
卧薪尝胆	wo xin chang dan
卧虎藏龙	wo hu cang long
危亡关头	wei wang guan tou
危在旦夕	wei zai dan xi
危如累卵	wei ru lei luan
危急关头	wei ji guan tou
危急存亡	wei ji cun wang
危机四伏	wei ji si fu
危言耸听	wei yan song ting
却之不恭	que zhi bu gong
卷土重来	juan tu chong lai
卸磨杀驴	xie mo sha lu
卿卿我我	qing qing wo wo
历久弥坚	li jiu mi jian
历历可数	li li ke shu
历历可见	li li ke jian
历历在目	li li zai mu
历尽沧桑	li jin cang sang
厉行节约	li xing jie yue
压倒一切	ya dao yi qie
厚古薄今	hou gu bo jin
厚德载物	hou de zai wu
厚此薄彼	hou ci bo bi
厚积薄发	hou ji bo fa
厚颜无耻	hou yan wu chi
原原本本	yuan yuan ben ben
原封不动	yuan feng bu dong
原封未动	yuan feng wei dong
原形毕露	yuan xing bi lu
原形败露	yuan xing bai lu
原汁原味	yuan zhi yuan wei
去伪存真	qu wei cun zhen
去粗取精	qu cu qu jing
去芜存精	qu wu cun jing
去芜存菁	qu wu cun jing
参差不一	cen ci bu yi
参差不齐	cen ci bu qi
参差错落	cen ci cuo luo
又惊又喜	you jing you xi
又红又专	you hong you zhuan
及时行乐	ji shi xing le
双喜临门	shuang xi lin men
双宿双飞	shuang su shuang fei
双管齐下	shuang guan qi xia
反反复复	fan fan fu fu
反咬一口	fan yao yi kou
反唇相讥	fan chun xiang ji
反复推敲	fan fu tui qiao
反复无常	fan fu wu chang
反客为主	fan ke wei zhu
反戈一击	fan ge yi ji
反戈相向	fan ge xiang xiang
反璞归真	fan pu gui zhen
反目成仇	fan mu cheng chou
反覆无常	fan fu wu chang
反败为胜	fan bai wei sheng
反躬自省	fan gong zi xing
反躬自问	fan gong zi wen
反面教材	fan mian jiao cai
发人深思	fa ren shen si
发人深省	fa ren shen xing
发号施令	fa hao shi ling
发奋图强	fa fen tu qiang
发家致富	fa jia zhi fu
发愤图强	fa fen tu qiang
发愤忘食	fa fen wang shi
发扬光大	fa yang guang da
发财致富	fa cai zhi fu
取之不尽	qu zhi bu jin
取信于人	qu xin yu ren
取信于民	qu xin yu min
取而代之	qu e dai zhi
取长补短	qu chang bu duan
受之有愧	shou zhi you kui
受制于人	shou zhi yu ren
受宠若惊	shou chong ruo jing
受益匪浅	shou yi fei qian
受益无穷	shou yi wu qiong
变化多端	bian hua duo duan
变化无常	bian hua wu chang
变化无穷	bian hua wu qiong
变化莫测	bian hua mo ce
变幻无常	bian huan wu chang
变幻无穷	bian huan wu qiong
变幻莫测	bian huan mo ce
变本加厉	bian ben jia li
叠床架屋	die chuang jia wu
口不择言	kou bu ze yan
口传心授	kou chuan xin shou
口出不逊	kou chu bu xun
口出狂言	kou chu kuang yan
口口声声	kou kou sheng sheng
口口相传	kou kou xiang chuan
口如悬河	kou ru xuan he
口干舌燥	kou gan she zao
口快心直	kou kuai xin zhi
口是心非	kou shi xin fei
口服心服	kou fu xin fu
口没遮拦	kou mei zhe lan
口直心快	kou zhi xin kuai
口耳相传	kou er xiang chuan
口若悬河	kou ruo xuan he
口蜜腹剑	kou mi fu jian
口诛笔伐	kou zhu bi fa
口说无凭	kou shuo wu ping
口齿伶俐	kou chi ling li
古为今用	gu wei jin yong
古井无波	gu jing wu bo
古今中外	gu jin zhong wai
古往今来	gu wang jin lai
古木参天	gu mu can tian
古稀之年	gu xi zhi nian
古色古香	gu se gu xiang
古道热肠	gu dao re chang
古香古色	gu xiang gu se
句斟字酌	ju zhen zi zhuo
另当别论	ling dang bie lun
另有所图	ling you suo tu
另有洞天	ling you dong tian
另眼相待	ling yan xiang dai
另眼相看	ling yan xiang kan
另眼看待	ling yan kan dai
另请高明	ling qing gao ming
另谋高就	ling mou gao jiu
另起炉灶	ling qi lu zao
另辟蹊径	ling pi xi jing
只争朝夕	zhi zheng zhao xi
只字不提	zhi zi bu ti
只手遮天	zhi shou zhe tian
只言片语	zhi yan pian yu
叫苦不迭	jiao ku bu die
叫苦连天	jiao ku lian tian
召之即来	zhao zhi ji lai
可乘之机	ke cheng zhi ji
可乘之隙	ke cheng zhi xi
可喜可贺	ke xi ke he
可圈可点	ke quan ke dian
可怜巴巴	ke lian ba ba
可想而知	ke xiang er zhi
可有可无	ke you ke wu
可歌可泣	ke ge ke qi
可见一斑	ke jian yi ban
叱咤风云	chi zha feng yun
史无前例	shi wu qian li
叶公好龙	ye gong hao long
叶落归根	ye luo gui gen
叶落知秋	ye luo zhi qiu
号啕大哭	hao tao da ku
司空见惯	si kong jian guan
叹为观止	tan wei guan zhi
吃哑巴亏	chi ya ba kui
吃喝玩乐	chi he wan le
吃大锅饭	chi da guo fan
吃苦耐劳	chi ku nai lao
吃里扒外	chi li pa wai
吃里爬外	chi li pa wai
吃闭门羹	chi bi men geng
各不相让	ge bu xiang rang
各个击破	ge ge ji po
各为其主	ge wei qi zhu
各取所长	ge qu suo chang
各取所需	ge qu suo xu
各司其事	ge si qi shi
各司其职	ge si qi zhi
各奔东西	ge ben dong xi
各奔前程	ge ben qian cheng
各就各位	ge jiu ge wei
各尽其责	ge jin qi ze
各尽所能	ge jin suo neng
各式各样	ge shi ge yang
各得其所	ge de qi suo
各执一词	ge zhi yi ci
各执己见	ge zhi ji jian
各抒己见	ge shu ji jian
各持己见	ge chi ji jian
各显神通	ge xian shen tong
各显身手	ge xian shen shou
各有利弊	ge you li bi
各有千秋	ge you qian qiu
各有所好	ge you suo hao
各有所爱	ge you suo ai
各有所短	ge you suo duan
各有所长	ge you suo cheng
各种各样	ge zhong ge yang
各自为战	ge zi wei zhan
各自为政	ge zi wei zheng
各色各样	ge se ge yang
各行其是	ge xing qi shi
各行其道	ge xing qi dao
各行各业	ge hang ge ye
合不拢嘴	he bu long zui
合二为一	he er wei yi
合情合理	he qing he li
合而为一	he er wei yi
吉人天相	ji ren tian xiang
吉星高照	ji xing gao zhao
吉祥如意	ji xiang ru yi
吊儿郎当	diao er lang dang
同仇敌忾	tong chou di kai
同出一辙	tong chu yi zhe
同室操戈	tong shi sao ge
同床共枕	tong chuang gong zhen
同床异梦	tong chuang yi meng
同归于尽	tong gui yu jin
同归殊途	tong gui shu tu
同心协力	tong xin xie li
同心合力	tong xin he li
同心同德	tong xin tong de
同日而语	tong ri er yu
同流合污	tong liu he wu
同甘共苦	tong gan gong ku
同生共死	tong sheng gong si
同病相怜	tong bing xiang lian
同窗好友	tong chuang hao you
同舟共济	tong zhou gong ji
名不副实	ming bu fu shi
名不符实	ming bu fu shi
名不虚传	ming bu xu chuan
名列前茅	ming lie qian mao
名利双收	ming li shuang shou
名副其实	ming fu qi shi
名噪一时	ming zao yi shi
名垂千古	ming chui qian gu
名垂青史	ming chui qing shi
名声在外	ming sheng zai wai
名声扫地	ming sheng sao di
名存实亡	ming cun shi wang
名实相符	ming shi xiang fu
名山大川	ming shan da chuan
名扬四海	ming yang si hai
名扬天下	ming yang tian xia
名正言顺	ming zheng yan shun
名满天下	ming man tian xia
名目繁多	ming mu fan duo
名胜古迹	ming sheng gu ji
名落孙山	ming luo sun shan
名誉扫地	ming yu sao di
名门望族	ming men wang zu
名闻天下	ming wen tian xia
名震一时	ming zhen yi shi
后会无期	hou hui wu qi
后会有期	hou hui you qi
后发制人	hou fa zhi ren
后台老板	hou tai lao ban
后悔莫及	hou hui mo ji
后患无穷	hou huan wu qiong
后来居上	hou lai ju shang
后生可畏	hou sheng ke wei
后继无人	hou ji wu ren
后继有人	hou ji you ren
后起之秀	hou qi zhi xiu
后院起火	hou yuan qi huo
后顾之忧	hou gu zhi you
吐故纳新	tu gu na xin
君子之交	jun zi zhi jiao
君子协定	jun zi xie ding
吞云吐雾	tun yun tu wu
吞吞吐吐	tun tun tu tu
否极泰来	pi ji tai lai
含冤受屈	han yuan shou qu
含含糊糊	han han hu hu
含情脉脉	han qing mo mo
含沙射影	han sha she ying
含笑九泉	han xiao jiu quan
含糊不清	han hu bu qing
含糊其词	han hu qi ci
含糊其辞	han hu qi ci
含苞待放	han bao dai fang
含苞欲放	han bao yu fang
含血喷人	han xue pen ren
含辛茹苦	han xin ru ku
听之任之	ting zhi ren zhi
听其自然	ting qi zi ran
听天由命	ting tian you ming
听而不闻	ting er bu wen
吵吵闹闹	chao chao nao nao
吹吹打打	chui chui da da
吹毛求疵	chui mao qiu ci
吹灰之力	chui hui zhi li
吹牛拍马	chui niu pai ma
呆头呆脑	dai tou dai nao
呆如木鸡	dai ru mu ji
呆若木鸡	dai ruo mu ji
告老还乡	gao lao huan xiang
呕心沥血	ou xin li xue
周而复始	zhou er fu shi
呱呱坠地	gu gu zhui di
味同嚼蜡	wei tong jiao la
呵欠连天	he qian lian tian
呼之欲出	hu zhi yu chu
呼朋唤友	hu peng huan you
呼来喝去	hu lai he qu
呼风唤雨	hu feng huan yu
命中注定	ming zhong zhu ding
命在旦夕	ming zai dan xi
命悬一线	ming xuan yi xian
命运多舛	ming yun duo chuan
命途多舛	ming tu duo chuan
咄咄怪事	duo duo guai shi
咄咄逼人	duo duo bi ren
和和气气	he he qi qi
和平共处	he ping gong chu
和气生财	he qi sheng cai
和盘托出	he pan tuo chu
和睦相处	he mu xiang chu
和而不同	he er bu tong
和蔼可亲	he ai ke qin
和蔼近人	he ai jin ren
和衷共济	he zhong gong ji
和颜悦色	he yan yue se
和风细雨	he feng xi yu
咎有应得	jiu you ying de
咎由自取	jiu you zi qu
咫尺天涯	zhi chi tian ya
咬文嚼字	yao wen jiao zi
咬牙切齿	yao ya qie chi
咬紧牙关	yao jin ya guan
咽喉要地	yan hou yao di
哀兵必胜	ai bing bi sheng
哀声叹气	ai sheng tan qi
哀痛欲绝	ai tong yu jue
哀而不伤	ai er bu shang
哀鸿遍地	ai hong bian di
哀鸿遍野	ai hong bian ye
品头论足	pin tou lun zu
品学兼优	pin xue jian you
哄堂大笑	hong tang da xiao
响彻云霄	xiang che yun xiao
哑口无言	ya kou wu yan
哑然失笑	ya ran shi xiao
哗众取宠	hua zhong qu chong
哭丧着脸	ku sang zhe lian
哭哭啼啼	ku ku ti ti
哭天喊地	ku tian han di
哭天抢地	ku tian qiang di
哭笑不得	ku xiao bu de
唇亡齿寒	chun wang chi han
唇枪舌剑	chun qiang she jian
唇红齿白	chun hong chi bai
唇齿相依	chun chi xiang yi
唉声叹气	ai sheng tan qi
唠唠叨叨	lao lao dao dao
唯利是图	wei li shi tu
唯命是从	wei ming shi cong
唯命是听	wei ming shi ting
唯唯诺诺	wei wei nuo nuo
唯妙唯肖	wei miao wei xiao
唯我独尊	wei wo du zun
唯才是举	wei cai shi ju
唯物主义	wei wu zhu yi
唱对台戏	chang dui tai xi
唾手可得	chui shou ke de
啧啧称奇	ze ze cheng qi
啧啧称赞	ze ze cheng zan
啼笑皆非	ti xiao jie fei
喃喃自语	nan nan zi yu
善始善终	shan shi shan zhong
善有善报	shan you shan bao
善男信女	shan nan xin nu
善罢甘休	shan ba gan xiu
善解人意	shan jie ren yi
喊冤叫屈	han yuan jiao qu
喋喋不休	die die bu xiu
喘息之机	chuan xi zhi ji
喜上眉梢	xi shang mei shao
喜不自禁	xi bu zi jin
喜不自胜	xi bu zi sheng
喜从天降	xi cong tian jiang
喜出望外	xi chu wang wai
喜形于色	xi xing yu se
喜怒哀乐	xi nu ai le
喜怒无常	xi nu wu chang
喜新厌旧	xi xin yan jiu
喜气洋洋	xi qi yang yang
喜笑颜开	xi xiao yan kai
喜闻乐见	xi wen le jian
喝西北风	he xi bei feng
喧宾夺主	xuan bin duo zhu
嗜杀成性	shi sha cheng xing
嗟来之食	jie lai zhi shi
嗤之以鼻	chi zhi yi bi
嗷嗷待哺	ao ao dai bu
嘘寒问暖	xu han wen nuan
嘴上功夫	zui shang gong fu
嘴硬心软	zui ying xin ruan
嘻嘻哈哈	xi xi ha ha
嘻皮笑脸	xi pi xiao lian
嘻笑怒骂	xi xiao nu ma
噤若寒蝉	jin ruo han chan
器宇轩昂	qi yu xuan ang
嚎啕大哭	hao tao da ku
囊中羞涩	nang zhong xiu se
囊空如洗	nang kong ru xi
四体不勤	si ti bu qin
四分五裂	si fen wu lie
四大皆空	si da jie kong
四平八稳	si ping ba wen
四海一家	si hai yi jia
四海为家	si hai wei jia
四脚朝天	si jiao chao tian
四通八达	si tong ba da
四面八方	si mian ba fang
四面受敌	si mian shou di
四面楚歌	si mian chu ge
四面碰壁	si mian peng bi
回光返照	hui guang fan zhao
回味无穷	hui wei wu qiong
回天之力	hui tian zhi li
回天乏术	hui tian fa shu
回天无力	hui tian wu li
回头是岸	hui tou shi an
回心转意	hui xin zhuan yi
回旋余地	hui xuan yu di
回眸一笑	hui mou yi xiao
因人而异	yin ren er yi
因势利导	yin shi li dao
因噎废食	yin ye fei shi
因地制宜	yin di zhi yi
因小失大	yin xiao shi da
因循守旧	yin xun shou jiu
因时制宜	yin shi zhi yi
因材施教	yin cai shi jiao
因果报应	yin guo bao ying
因祸得福	yin huo de fu
因陋就简	yin lou jiu jian
团结一致	tuan jie yi zhi
囤积居奇	tun ji ju qi
囫囵吞枣	hu lun tun zao
困兽犹斗	kun shou you dou
围追堵截	wei zhui du jie
围魏救赵	wei wei jiu zhao
固守成规	gu shou cheng gui
固执己见	gu zhi ji jian
固步自封	gu bu zi feng
固若金汤	gu ruo jin tang
国仇家恨	guo chou jia hen
国家栋梁	guo jia dong liang
国富民安	guo fu min an
国富民强	guo fu min qiang
国泰民安	guo tai min an
国破家亡	guo po jia wang
国色天香	guo se tian xiang
国计民生	guo ji min sheng
国难当头	guo nan dang tou
图文并茂	tu wen bing mao
图穷匕现	tu qiong bi xian
图穷匕见	tu qiong bi xian
图谋不轨	tu mou bu gui
图财害命	tu cai hai ming
土崩瓦解	tu beng wa jie
土洋结合	tu yang jie he
土生土长	tu sheng tu zhang
土豪劣绅	tu hao lie shen
土里土气	tu li tu qi
在劫难逃	zai jie nan tao
在所不惜	zai suo bu xi
在所不辞	zai suo bu ci
在所难免	zai suo nan mian
在此一举	zai ci yi ju
地主之谊	di zhu zhi yi
地久天长	di jiu tian chang
地利人和	di li ren he
地动山摇	di dong shan yao
地地道道	di di dao dao
地大物博	di da wu bo
地广人稀	di guang ren xi
地覆天翻	di fu tian fan
坎坷不平	kan ke bu ping
坐井观天	zuo jing guan tian
坐享其成	zuo xiang qi cheng
坐以待毙	zuo yi dai bi
坐冷板凳	zuo leng ban deng
坐卧不宁	zuo wo bu ning
坐卧不安	zuo wo bu an
坐吃山空	zuo chi shan kong
坐失时机	zuo shi shi ji
坐失良机	zuo shi liang ji
坐怀不乱	zuo huai bu luan
坐收其利	zuo shou qi li
坐收渔利	zuo shou yu li
坐无虚席	zuo wu xu xi
坐立不安	zuo li bu an
坐而论道	zuo er lun dao
坐观成败	zuo guan cheng bai
坐视不救	zuo shi bu jiu
坐视不理	zuo shi bu li
坐视不顾	zuo shi bu gu
坑坑洼洼	keng keng wa wa
坑蒙拐骗	keng meng guai pian
坚不可摧	jian bu ke cui
坚如磐石	jian ru pan shi
坚定不移	jian ding bu yi
坚强不屈	jian qiang bu qu
坚忍不拔	jian ren bu ba
坚持不懈	jian chi bu xie
坚持不渝	jian chi bu yu
坚苦卓绝	jian ku zhuo jue
坚贞不屈	jian zhen bu qu
坚贞不渝	jian zhen bu yu
坚韧不拔	jian ren bu ba
坦然自若	tan ran zi ruo
垂头丧气	chui tou sang qi
垂帘听政	chui lian ting zheng
垂手可得	chui shou ke de
垂死挣扎	chui si zheng zha
垂涎三尺	chui xian san chi
垂涎欲滴	chui xian yu di
埋头苦干	mai tou ku gan
埋没人才	mai mo ren cai
城下之盟	cheng xia zhi meng
堂堂正正	tang tang zheng zheng
堂而皇之	tang er huang zhi
堆积如山	dui ji ru shan
堆积成山	dui ji cheng shan
塞翁之马	sai weng zhi ma
塞翁失马	sai weng shi ma
增收节支	zeng shou jie zhi
墨守成规	mo shou cheng gui
壁垒分明	bi lei fen ming
壁垒森严	bi lei sen yan
壮士断腕	zhuang shi duan wan
壮志凌云	zhuang zhi ling yun
壮志未酬	zhuang zhi wei chou
壮志难酬	zhuang zhi nan chou
声东击西	sheng dong ji xi
声势浩大	sheng shi hao da
声名大噪	sheng ming da zao
声名狼藉	sheng ming lang ji
声名鹊起	sheng ming que qi
声嘶力竭	sheng si li jie
声如洪钟	sheng ru hong zhong
声情并茂	sheng qing bing mao
声泪俱下	sheng lei ju xia
声色俱厉	sheng se ju li
声誉鹊起	sheng yu que qi
处之泰然	chu zhi tai ran
处心积虑	chu xin ji lu
夕阳西下	xi yang xi xia
外交辞令	wai jiao ci ling
外圆内方	wai yuan nei fang
外强中干	wai qiang zhong gan
外柔内刚	wai rou nei gang
多事之秋	duo shi zhi qiu
多劳多得	duo lao duo de
多嘴多舌	duo zui duo she
多多少少	duo duo shao shao
多多益善	duo duo yi shan
多如牛毛	duo ru niu mao
多姿多彩	duo zi duo cai
多快好省	duo kuai hao sheng
多情善感	duo qing shan gan
多愁善感	duo chou shan gan
多才多艺	duo cai duo yi
多此一举	duo ci yi ju
多灾多难	duo zai duo nan
多种多样	duo zhong duo yang
多管闲事	duo guan xian shi
多谋善断	duo mou shan duan
多难兴邦	duo nan xing bang
夜不闭户	ye bu bi hu
夜以继日	ye yi ji ri
夜半三更	ye ban san geng
夜深人静	ye shen ren jing
夜郎自大	ye lang zi da
夜长梦多	ye chang meng duo
夜阑人静	ye lan ren jing
大举进攻	da ju jin gong
大义凛然	da yi lin ran
大义灭亲	da yi mie qin
大书特书	da shu te shu
大事化小	da shi hua xiao
大做文章	da zuo wen zhang
大公无私	da gong wu si
大兴土木	da xing tu mu
大出风头	da chu feng tou
大刀阔斧	da dao kuo fu
大功告成	da gong gao cheng
大动干戈	da dong gan ge
大动肝火	da dong gan huo
大势已去	da shi yi qu
大势所趋	da shi suo qu
大包大揽	da bao da lan
大千世界	da qian shi jie
大卸八块	da xie ba kuai
大厦将倾	da sha jiang qing
大发慈悲	da fa ci bei
大发横财	da fa heng cai
大发议论	da fa yi lun
大发雷霆	da fa lei ting
大可不必	da ke bu bi
大吃一惊	da chi yi jing
大吃大喝	da chi da he
大吉大利	da ji da li
大同小异	da tong xiao yi
大名鼎鼎	da ming ding ding
大吵大闹	da chao da nao
大吹大擂	da chui da lei
大吼大叫	da hou da jiao
大呼小叫	da hu xiao jiao
大喊大叫	da han da jiao
大喜过望	da xi guo wang
大器晚成	da qi wan cheng
大地回春	da di hui chun
大声疾呼	da sheng ji hu
大处着眼	da chu zhuo yan
大大咧咧	da da lie lie
大大小小	da da xiao xiao
大大方方	da da fang fang
大失所望	da shi suo wang
大好河山	da hao he shan
大家闺秀	da jia gui xiu
大家风范	da jia feng fan
大富大贵	da fu da gui
大展宏图	da zhan hong tu
大巧若拙	da qiao ruo zhuo
大度包容	da du bao rong
大度豁达	da du huo da
大庭广众	da ting guang zhong
大开大合	da kai da he
大开眼界	da kai yan jie
大张声势	da zhang sheng shi
大张旗鼓	da zhang qi gu
大彻大悟	da che da wu
大得人心	da de ren xin
大快人心	da kuai ren xin
大恩大德	da en da de
大惊失色	da jing shi se
大惊小怪	da jing xiao guai
大惑不解	da huo bu jie
大慈大悲	da ci da bei
大手大脚	da shou da jiao
大才小用	da cai xiao yong
大打出手	da da chu shou
大捞一把	da lao yi ba
大摇大摆	da yao da bai
大放厥词	da fang jue ci
大政方针	da zheng fang zhen
大敌当前	da di dang qian
大是大非	da shi da fei
大显神通	da xian shen tong
大显身手	da xian shen shou
大智大勇	da zhi da yong
大智如愚	da zhi ru yu
大智若愚	da zhi ruo yu
大有人在	da you ren zai
大有作为	da you zuo wei
大有可为	da you ke wei
大有可观	da you ke guan
大有希望	da you xi wang
大有文章	da you wen zhang
大有裨益	da you bi yi
大有起色	da you qi se
大权在握	da quan zai wo
大权旁落	da quan pang luo
大权独揽	da quan du lan
大材小用	da cai xiao yong
大梦初醒	da meng chu xing
大模大样	da mu da yang
大步流星	da bu liu xing
大气磅礴	da qi pang bo
大汗淋漓	da han lin li
大江南北	da jiang nan bei
大浪淘沙	da lang tao sha
大海捞针	da hai lao zhen
大煞风景	da sha feng jing
大相径庭	da xiang jing ting
大祸临头	da huo lin tou
大禹治水	da yu zhi shui
大笔一挥	da bi yi hui
大红大紫	da hong da zi
大而化之	da er hua zhi
大而无当	da er wu dang
大肆宣传	da si xuan chuan
大肆挥霍	da si hui huo
大肆攻击	da si gong ji
大腹便便	da fu pian pian
大获全胜	da huo quan sheng
大街小巷	da jie xiao xiang
大言不惭	da yan bu can
大败涂地	da bai tu di
大败而逃	da bai er tao
大费周折	da fei zhou zhe
大起大落	da qi da luo
大跌眼镜	da die yan jing
大逆不道	da ni bu dao
大错特错	da cuo te cuo
大难不死	da nan bu si
大难临头	da nan lin tou
大雅之堂	da ya zhi tang
大雨倾盆	da yu qing pen
大雨如注	da yu ru zhu
大雨滂沱	da yu pang tuo
大雪纷飞	da xue fen fei
大风大浪	da feng da lang
大饱眼福	da bao yan fu
大鱼大肉	da yu da rou
天下一家	tian xia yi jia
天下为公	tian xia wei gong
天下大乱	tian xia da luan
天下太平	tian xia tai ping
天下无双	tian xia wu shuang
天下无敌	tian xia wu di
天下第一	tian xia di yi
天之骄子	tian zhi jiao zi
天伦之乐	tian lun zhi le
天作之合	tian zuo zhi he
天南地北	tian nan di bei
天南海北	tian nan hai bei
天各一方	tian ge yi fang
天地不容	tian di bu rong
天地良心	tian di liang xin
天塌地陷	tian ta di xian
天壤之别	tian rang zhi bie
天壤之隔	tian rang zhi ge
天外有天	tian wai you tian
天女散花	tian nu san hua
天姿国色	tian zi guo se
天寒地冻	tian han di dong
天崩地裂	tian beng di lie
天府之国	tian fu zhi guo
天怒人怨	tian nu ren yuan
天打雷劈	tian da lei pi
天摇地动	tian yao di dong
天文数字	tian wen shu zi
天方夜谭	tian fang ye tan
天旋地转	tian xuan di zhuan
天昏地暗	tian hun di an
天朗气清	tian lang qi qing
天涯海角	tian ya hai jiao
天渊之别	tian yuan zhi bie
天灾人祸	tian zai ren huo
天理不容	tian li bu rong
天理难容	tian li nan rong
天生一对	tian sheng yi dui
天生丽质	tian sheng li zhi
天真无邪	tian zhen wu xie
天真烂漫	tian zhen lan man
天经地义	tian jing di yi
天网恢恢	tian wang hui hui
天罗地网	tian luo di wang
天翻地覆	tian fan di fu
天花乱坠	tian hua luan zhui
天荒地老	tian huang di lao
天衣无缝	tian yi wu feng
天诛地灭	tian zhu di mie
天赐良机	tian ci liang ji
天造地设	tian zao di she
天道酬勤	tian dao chou qin
天长地久	tian chang di jiu
天长日久	tian chang ri jiu
天马行空	tian ma xing kong
天高地厚	tian gao di hou
天高气爽	tian gao qi shuang
太平无事	tai ping wu shi
太平盛世	tai ping sheng shi
大慈大悲	da ci da bei
大手大脚	da shou da jiao
大才小用	da cai xiao yong
大打出手	da da chu shou
大摇大摆	da yao da bai
大放厥词	da fang jue ci
大政方针	da zheng fang zhen
大敌当前	da di dang qian
大是大非	da shi da fei
大显神通	da xian shen tong
大显身手	da xian shen shou
大智大勇	da zhi da yong
大智如愚	da zhi ru yu
大智若愚	da zhi ruo yu
大有人在	da you ren zai
大有作为	da you zuo wei
大有可为	da you ke wei
大有可观	da you ke guan
大有希望	da you xi wang
大有文章	da you wen zhang
大有裨益	da you bi yi
大有起色	da you qi se
大权在握	da quan zai wo
大权旁落	da quan pang luo
大权独揽	da quan du lan
大材小用	da cai xiao yong
大梦初醒	da meng chu xing
大模大样	da mu da yang
大步流星	da bu liu xing
大气磅礴	da qi pang bo
大汗淋漓	da han lin li
大江南北	da jiang nan bei
大浪淘沙	da lang tao sha
大海捞针	da hai lao zhen
大煞风景	da sha feng jing
大相径庭	da xiang jing ting
大破大立	da po da li
大祸临头	da huo lin tou
大禹治水	da yu zhi shui
大笔一挥	da bi yi hui
大红大紫	da hong da zi
大红大绿	da hong da lu
大而化之	da er hua zhi
大肆宣传	da si xuan chuan
大肆挥霍	da si hui huo
大肆攻击	da si gong ji
大腹便便	da fu pian pian
大获全胜	da huo quan sheng
大街小巷	da jie xiao xiang
大言不惭	da yan bu can
大败涂地	da bai tu di
大败而逃	da bai er tao
大费周折	da fei zhou zhe
大起大落	da qi da luo
大跌眼镜	da die yan jing
大逆不道	da ni bu dao
大错特错	da cuo te cuo
大难不死	da nan bu si
大难临头	da nan lin tou
大雅之堂	da ya zhi tang
大雨倾盆	da yu qing pen
大雨滂沱	da yu pang tuo
大雪纷飞	da xue fen fei
大风大浪	da feng da lang
大饱眼福	da bao yan fu
大鱼大肉	da yu da rou
天下一家	tian xia yi jia
天下为公	tian xia wei gong
天下大乱	tian xia da luan
天下太平	tian xia tai ping
天下无双	tian xia wu shuang
天下无敌	tian xia wu di
天下第一	tian xia di yi
天不作美	tian bu zuo mei
天之骄子	tian zhi jiao zi
天伦之乐	tian lun zhi le
天作之合	tian zuo zhi he
天南地北	tian nan di bei
天南海北	tian nan hai bei
天各一方	tian ge yi fang
天壤之别	tian rang zhi bie
天壤之隔	tian rang zhi ge
天外有天	tian wai you tian
天女散花	tian nu san hua
天姿国色	tian zi guo se
天寒地冻	tian han di dong
天崩地裂	tian beng di lie
天府之国	tian fu zhi guo
天怒人怨	tian nu ren yuan
天打雷劈	tian da lei pi
天摇地动	tian yao di dong
天文数字	tian wen shu zi
天方夜谭	tian fang ye tan
天旋地转	tian xuan di zhuan
天昏地暗	tian hun di an
天朗气清	tian lang qi qing
天涯海角	tian ya hai jiao
天渊之别	tian yuan zhi bie
天灾人祸	tian zai ren huo
天理不容	tian li bu rong
天理难容	tian li nan rong
天生一对	tian sheng yi dui
天生丽质	tian sheng li zhi
天真无邪	tian zhen wu xie
天真烂漫	tian zhen lan man
天经地义	tian jing di yi
天网恢恢	tian wang hui hui
天罗地网	tian luo di wang
天翻地覆	tian fan di fu
天花乱坠	tian hua luan zhui
天荒地老	tian huang di lao
天衣无缝	tian yi wu feng
天诛地灭	tian zhu di mie
天赐良机	tian ci liang ji
天造地设	tian zao di she
天道酬勤	tian dao chou qin
天长地久	tian chang di jiu
天长日久	tian chang ri jiu
天马行空	tian ma xing kong
天高地厚	tian gao di hou
天高气爽	tian gao qi shuang
太平无事	tai ping wu shi
太平盛世	tai ping sheng shi
夫唱妇随	fu chang fu sui
失之交臂	shi zhi jiao bi
失声痛哭	shi sheng tong ku
失神落魄	shi shen luo po
失而复得	shi er fu de
失道寡助	shi dao gua zhu
失魂落魄	shi hun luo po
头头是道	tou tou shi dao
头昏目眩	tou hun mu xuan
头昏眼花	tou hun yan hua
头昏脑胀	tou hun nao zhang
头晕目眩	tou yun mu xuan
头晕眼花	tou yun yan hua
头疼脑热	tou teng nao re
头皮发麻	tou pi fa ma
头破血流	tou po xue liu
头重脚轻	tou zhong jiao qing
头面人物	tou mian ren wu
夷为平地	yi wei ping di
夸大其词	kua da qi ci
夸大其辞	kua da qi ci
夸夸其谈	kua kua qi tan
夸父追日	kua fu zhui ri
夹道欢呼	jia dao huan hu
夺眶而出	duo kuang er chu
夺门而出	duo men er chu
奄奄一息	yan yan yi xi
奇形怪状	qi xing guai zhuang
奇思妙想	qi si miao xiang
奇文共赏	qi wen gong shang
奇珍异宝	qi zhen yi bao
奇耻大辱	qi chi da ru
奇花异草	qi hua yi cao
奇装异服	qi zhuang yi fu
奇谈怪论	qi tan guai lun
奇货可居	qi huo ke ju
奉为楷模	feng wei kai mo
奉为神明	feng wei shen ming
奉为至宝	feng wei zhi bao
奉公守法	feng gong shou fa
奉若神明	feng ruo shen ming
奋不顾身	fen bu gu shen
奋勇争先	fen yong zheng xian
奋勇前进	fen yong qian jin
奋勇当先	fen yong dang xian
奋发向上	fen fa xiang shang
奋发图强	fen fa tu qiang
奋发有为	fen fa you wei
奋笔疾书	fen bi ji shu
奋起直追	fen qi zhi zhui
奔流不息	ben liu bu xi
奔走呼号	ben zou hu hao
奔走相告	ben zou xiang gao
奖罚分明	jiang fa fen ming
奥妙无穷	ao miao wu qiong
女中豪杰	nu zhong hao jie
女大当嫁	nu da dang jia
女娲补天	nu wa bu tian
女扮男装	nu ban nan zhuang
女流之辈	nu liu zhi bei
奴颜婢膝	nu yan bi xi
奴颜媚骨	nu yan mei gu
奸夫淫妇	jian fu yin fu
奸臣当道	jian chen dang dao
好为人师	hao wei ren shi
好事之徒	hao shi zhi tu
好事多磨	hao shi duo mo
好事成双	hao shi cheng shuang
好吃懒做	hao chi lan zuo
好声好气	hao sheng hao qi
好大喜功	hao da xi gong
好好先生	hao hao xian sheng
好学不倦	hao xue bu juan
好心好意	hao xin hao yi
好戏连台	hao xi lian tai
好景不常	hao jing bu chang
好景不长	hao jing bu chang
好梦不长	hao meng bu chang
好管闲事	hao guan xian shi
好自为之	hao zi wei zhi
好色之徒	hao se zhi tu
好言好语	hao yan hao yu
好说歹说	hao shuo dai shuo
好逸恶劳	hao yi wu lao
好高骛远	hao gao wu yuan
如临大敌	ru lin da di
如临深渊	ru lin shen yuan
如出一辙	ru chu yi zhe
如坐针毡	ru zuo zhen zhan
如履平地	ru lu ping di
如履薄冰	ru lu bo bing
如影随形	ru ying sui xing
如意算盘	ru yi suan pan
如愿以偿	ru yuan yi chang
如数家珍	ru shu jia zhen
如无其事	ru wu qi shi
如日中天	ru ri zhong tian
如梦初醒	ru meng chu xing
如梦方醒	ru meng fang xing
如此而已	ru ci er yi
如法炮制	ru fa pao zhi
如泣如诉	ru qi ru su
如火如荼	ru huo ru tu
如火燎原	ru huo liao yuan
如狼似虎	ru lang si hu
如痴似醉	ru chi si zui
如痴如狂	ru chi ru kuang
如痴如醉	ru chi ru zui
如胶似漆	ru jiao si qi
如胶如漆	ru jiao ru qi
如臂使指	ru bi shi zhi
如芒刺背	ru mang ci bei
如芒在背	ru mang zai bei
如花似玉	ru hua si yu
如花似锦	ru hua si jin
如获至宝	ru huo zhi bao
如虎添翼	ru hu tian yi
如醉如痴	ru zui ru chi
如释重负	ru shi zhong fu
如雷贯耳	ru lei guan er
如饥似渴	ru ji si ke
如饥如渴	ru ji ru ke
如鱼得水	ru yu de shui
如鲠在喉	ru geng zai hou
如鸟兽散	ru niao shou san
妄自尊大	wang zi zun da
妄自菲薄	wang zi fei bo
妆模作样	zhuang mo zuo yang
妇人之仁	fu ren zhi ren
妇人之见	fu ren zhi jian
妇孺皆知	fu ru jie zhi
妒火中烧	du huo zhong shao
妖言惑众	yao yan huo zhong
妖魔鬼怪	yao mo gui guai
妙不可言	miao bu ke yan
妙手偶得	miao shou ou de
妙手回春	miao shou hui chun
妙笔生花	miao bi sheng hua
妙语如珠	miao yu ru zhu
妙语连珠	miao yu lian zhu
妙趣横生	miao qu heng sheng
妥妥当当	tuo tuo dang dang
妻儿老小	qi er lao xiao
妻离子散	qi li zi san
始乱终弃	shi luan zhong qi
始作俑者	shi zuo yong zhe
始料不及	shi liao bu ji
始终不渝	shi zhong bu yu
始终如一	shi zhong ru yi
姑息养奸	gu xi yang jian
委曲求全	wei qu qiu quan
委靡不振	wei mi bu zhen
姗姗来迟	shan shan lai chi
姹紫嫣红	cha zi yan hong
威信扫地	wei xin sao di
威武不屈	wei wu bu qu
威胁利诱	wei xie li you
威迫利诱	wei po li you
威震天下	wei zhen tian xia
威风八面	wei feng ba mian
威风凛凛	wei feng lin lin
威风扫地	wei feng sao di
娇小玲珑	jiao xiao ling long
娇生惯养	jiao sheng guan yang
娓娓动听	wei wei dong ting
娓娓而谈	wei wei er tan
婀娜多姿	e nuo duo zi
婆婆妈妈	po po ma ma
婉言谢绝	wan yan xie jue
嫁祸于人	jia huo yu ren
嫉恶如仇	ji e ru chou
嫉贤妒能	ji xian du neng
嫌贫爱富	xian pin ai fu
嫣然一笑	yan ran yi xiao
嫦娥奔月	chang e ben yue
嬉皮笑脸	xi pi xiao lian
嬉笑怒骂	xi xiao nu ma
子子孙孙	zi zi sun sun
子孙后代	zi sun hou dai
子承父业	zi cheng fu ye
子虚乌有	zi xu wu you
孑然一身	jie ran yi shen
字字珠玑	zi zi zhu ji
字斟句酌	zi zhen ju zhuo
字正腔圆	zi zheng qiang yuan
字里行间	zi li hang jian
存心不良	cun xin bu liang
孜孜不倦	zi zi bu juan
孜孜以求	zi zi yi qiu
孝子贤孙	xiao zi xian sun
孟母三迁	meng mu san qian
孤儿寡妇	gu er gua fu
孤儿寡母	gu er gua mu
孤军作战	gu jun zuo zhan
孤军奋战	gu jun fen zhan
孤军深入	gu jun shen ru
孤孤单单	gu gu dan dan
孤家寡人	gu jia gua ren
孤掌难鸣	gu zhang nan ming
孤注一掷	gu zhu yi zhi
孤男寡女	gu nan gua nu
孤立无助	gu li wu zhu
孤立无援	gu li wu yuan
孤芳自赏	gu fang zi shang
孤苦伶仃	gu ku ling ding
孤陋寡闻	gu lou gua wen
学业有成	xue ye you cheng
学以致用	xue yi zhi yong
学富五车	xue fu wu che
学无止境	xue wu zhi jing
学海无涯	xue hai wu ya
学而不厌	xue er bu yan
学识渊博	xue shi yuan bo
学贯中西	xue guan zhong xi
孺子可教	ru zi ke jiao
宁折不弯	ning zhe bu wan
宁死不屈	ning si bu qu
宁缺勿滥	ning que wu lan
宁缺毋滥	ning que wu lan
宅心仁厚	zhai xin ren hou
守口如瓶	shou kou ru ping
守望相助	shou wang xiang zhu
守株待兔	shou zhu dai tu
守身如玉	shou shen ru yu
安不忘危	an bu wang wei
安之若素	an zhi ruo su
安于现状	an yu xian zhuang
安份守己	an fen shou ji
安分守己	an fen shou ji
安如泰山	an ru tai shan
安如磐石	an ru pan shi
安安分分	an an fen fen
安安稳稳	an an wen wen
安安静静	an an jing jing
安定团结	an ding tuan jie
安家立业	an jia li ye
安家落户	an jia luo hu
安居乐业	an ju le ye
安然无事	an ran wu shi
安然无恙	an ran wu yang
安营扎寨	an ying zha zhai
安贫乐道	an pin le dao
安身之地	an shen zhi di
安身之处	an shen zhi chu
安身立命	an shen li ming
安邦治国	an bang zhi guo
安闲自在	an xian zi zai
完好无缺	wan hao wu que
完整无缺	wan zheng wu que
完璧归赵	wan bi gui zhao
完美无瑕	wan mei wu xia
完美无缺	wan mei wu que
宏伟壮观	hong wei zhuang guan
宏图大志	hong tu da zhi
官僚主义	guan liao zhu yi
官复原职	guan fu yuan zhi
官官相卫	guan guan xiang wei
官官相护	guan guan xiang hu
官样文章	guan yang wen zhang
官运亨通	guan yun heng tong
官逼民反	guan bi min fan
定时炸弹	ding shi zha dan
宛转悠扬	wan zhuan you yang
宝刀不老	bao dao bu lao
宝刀未老	bao dao wei lao
实不相瞒	shi bu xiang man
实事求是	shi shi qiu shi
实实在在	shi shi zai zai
实心实意	shi xin shi yi
实至名归	shi zhi ming gui
实话实说	shi hua shi shuo
宠辱不惊	chong ru bu jing
审时度势	shen shi duo shi
客客气气	ke ke qi qi
客死他乡	ke si ta xiang
害人不浅	hai ren bu qian
害群之马	hai qun zhi ma
家喻户晓	jia yu hu xiao
家大业大	jia da ye da
家学渊源	jia xue yuan yuan
家家户户	jia jia hu hu
家常便饭	jia chang bian fan
家常里短	jia chang li duan
家徒四壁	jia tu si bi
家破人亡	jia po ren wang
家财万贯	jia cai wan guan
家贼难防	jia zei nan fang
家道中落	jia dao zhong luo
家长里短	jia chang li duan
容光焕发	rong guang huan fa
容身之地	rong shen zhi di
宽以待人	kuan yi dai ren
宽大为怀	kuan da wei huai
宽宏大度	kuan hong da du
宽宏大量	kuan hong da liang
宽洪大量	kuan hong da liang
宾客盈门	bin ke ying men
宾朋满座	bin peng man zuo
宾至如归	bin zhi ru gui
寂然无声	ji ran wu sheng
寄人篱下	ji ren li xia
寅吃卯粮	yin chi mao liang
密不可分	mi bu ke fen
密不通风	mi bu tong feng
密密麻麻	mi mi ma ma
富丽堂皇	fu li tang huang
富可敌国	fu ke di guo
富国强兵	fu guo qiang bing
富国强民	fu guo qiang min
富贵荣华	fu gui rong hua
寒冬腊月	han dong la yue
寒来暑往	han lai shu wang
寒风刺骨	han feng ci gu
寓情于景	yu qing yu jing
寓意深远	yu yi shen yuan
寝食不安	qin shi bu an
察言观色	cha yan guan se
察颜观色	cha yan guan se
寡不敌众	gua bu di zhong
寡廉鲜耻	gua lian xian chi
寡言少语	gua yan shao yu
寥寥可数	liao liao ke shu
寥寥无几	liao liao wu ji
寥若晨星	liao ruo chen xing
寸土不让	cun tu bu rang
寸土必争	cun tu bi zheng
寸步不离	cun bu bu li
寸步不让	cun bu bu rang
寸步难移	cun bu nan yi
寸步难行	cun bu nan xing
寸草不生	cun cao bu sheng
寸草不留	cun cao bu liu
对号入座	dui hao ru zuo
对天发誓	dui tian fa shi
对牛弹琴	dui niu tan qin
对症下药	dui zheng xia yao
对答如流	dui da ru liu
对簿公堂	dui bu gong tang
对酒当歌	dui jiu dang ge
寻寻觅觅	xun xun mi mi
寻根究底	xun gen jiu di
寻根问底	xun gen wen di
寻欢作乐	xun huan zuo le
寻死觅活	xun si mi huo
寻花问柳	xun hua wen liu
寻衅闹事	xun xin nao shi
寿比南山	shou bi nan shan
寿终正寝	shou zhong zheng qin
将信将疑	jiang xin jiang yi
将功折罪	jiang gong zhe zui
将功补过	jiang gong bu guo
将功赎罪	jiang gong shu zui
将心比心	jiang xin bi xin
将计就计	jiang ji jiu ji
将错就错	jiang cuo jiu cuo
尊姓大名	zun xing da ming
尊师重道	zun shi zhong dao
小中见大	xiao zhong jian da
小人得志	xiao ren de zhi
小偷小摸	xiao tou xiao mo
小家子气	xiao jia zi qi
小家碧玉	xiao jia bi yu
小巧玲珑	xiao qiao ling long
小康之家	xiao kang zhi jia
小康人家	xiao kang ren jia
小心眼儿	xiao xin yan er
小心翼翼	xiao xin yi yi
小心谨慎	xiao xin jin shen
小恩小惠	xiao en xiao hui
小惩大戒	xiao cheng da jie
小惩大诫	xiao cheng da jie
小打小闹	xiao da xiao nao
小本经营	xiao ben jing ying
小肚鸡肠	xiao du ji chang
小菜一碟	xiao cai yi die
小试牛刀	xiao shi niu dao
小试锋芒	xiao shi feng mang
小道消息	xiao dao xiao xi
小里小气	xiao li xiao qi
小题大作	xiao ti da zuo
小题大做	xiao ti da zuo
小鸟依人	xiao niao yi ren
少不更事	shao bu geng shi
少安勿躁	shao an wu zao
少年老成	shao nian lao cheng
少见多怪	shao jian duo guai
少言寡语	shao yan gua yu
尔虞我诈	er yu wo zha
尖嘴猴腮	jian zui hou sai
尖嘴薄舌	jian zui bo she
尖酸刻薄	jian suan ke bo
尘埃落定	chen ai luo ding
就事论事	jiu shi lun shi
就地取材	jiu di qu cai
就地正法	jiu di zheng fa
尸横遍野	shi heng bian ye
尸骨未寒	shi gu wei han
尺有所短	chi you suo duan
尽人皆知	jin ren jie zhi
尽其所能	jin qi suo neng
尽力而为	jin li er wei
尽善尽美	jin shan jin mei
尽如人意	jin ru ren yi
尽心尽力	jin xin jin li
尽心竭力	jin xin jie li
尽忠报国	jin zhong bao guo
尽收眼底	jin shou yan di
尽释前嫌	jin shi qian xian
尾大不掉	wei da bu diao
局促不安	ju cu bu an
屁滚尿流	pi gun niao liu
层出不穷	ceng chu bu qiong
层层加码	ceng ceng jia ma
层层深入	ceng ceng shen ru
层峦叠嶂	ceng luan die zhang
层次分明	ceng ci fen ming
居功自傲	ju gong zi ao
居安思危	ju an si wei
居心不良	ju xin bu liang
居心何在	ju xin he zai
居心叵测	ju xin po ce
居心险恶	ju xin xian e
居高临下	ju gao lin xia
屈打成招	qu da cheng zhao
屈指一算	qu zhi yi suan
屈指可数	qu zhi ke shu
屏气凝神	bing qi ning shen
展翅高飞	zhan chi gao fei
屡战屡败	lu zhan lu bai
屡教不改	lu jian bu gai
屡次三番	lu ci san fan
屡见不鲜	lu jian bu xian
屡试不爽	lu shi bu shuang
山光水色	shan guang shui se
山南海北	shan nan hai bei
山回路转	shan hui lu zhuan
山崩地裂	shan beng di lie
山摇地动	shan yao di dong
山明水秀	shan ming shui xiu
山水相连	shan shui xiang lian
山清水秀	shan qing shui xiu
山珍海味	shan zhen hai wei
山盟海誓	shan meng hai shi
山穷水尽	shan qiong shui jin
山重水复	shan chong shui fu
山雨欲来	shan yu yu lai
山高水远	shan gao shui yuan
山高水长	shan gao shui chang
山高路远	shan gao lu yuan
屹立不动	yi li bu dong
岁月如流	sui yue ru liu
岁月蹉跎	sui yue cuo tuo
岂有此理	qi you ci li
岌岌可危	ji ji ke wei
岿然不动	kui ran bu dong
峥嵘岁月	zheng rong sui yue
峰回路转	feng hui lu zhuan
崇山峻岭	chong shan jun ling
崇洋媚外	chong yang mei wai
崎岖不平	qi qu bu ping
崭露头角	zhan lu tou jiao
崭露锋芒	zhan lu feng mang
巍然不动	wei ran bu dong
巍然屹立	wei ran yi li
川流不息	chuan liu bu xi
工于心计	gong yu xin ji
左冲右撞	zuo chong you zhuang
左冲右突	zuo chong you tu
左右两难	zuo you liang nan
左右为难	zuo you wei nan
左右开弓	zuo you kai gong
左右摇摆	zuo you yao bai
左右逢源	zuo you feng yuan
左思右想	zuo si you xiang
左拥右抱	zuo yong you bao
左支右绌	zuo zhi you chu
左膀右臂	zuo bang you bi
左说右说	zuo shuo you shuo
左躲右闪	zuo duo you shan
左邻右舍	zuo lin you she
左顾右盼	zuo gu you pan
巧取豪夺	qiao qu hao duo
巧夺天工	qiao duo tian gong
巧妙绝伦	qiao miao jue lun
巧立名目	qiao li ming mu
巧舌如簧	qiao she ru huang
巧言令色	qiao yan ling se
差强人意	cha qiang ren yi
已成定局	yi cheng ding ju
巾帼英雄	jin guo ying xiong
师出无名	shi chu wu ming
师出有名	shi chu you ming
师道尊严	shi dao zun yan
带罪立功	dai zui li gong
席地而坐	xi di er zuo
常备不懈	chang bei bu xie
常年累月	chang nian lei yue
常来常往	chang lai chang wang
常胜将军	chang sheng jiang jun
幕后操纵	mu hou cao zong
幡然悔悟	fan ran hui wu
干净利索	gan jing li suo
干净利落	gan jing li luo
干干净净	gan gan jing jing
干柴烈火	gan chai lie huo
干脆利索	gan cui li suo
干脆利落	gan cui li luo
平分秋色	ping fen qiu se
平头百姓	ping tou bai xing
平安无事	ping an wu shi
平平安安	ping ping an an
平平淡淡	ping ping dan dan
平庸之辈	ping yong zhi bei
平心而论	ping xin er lun
平心静气	ping xin jing qi
平易近人	ping yi jin ren
平步登天	ping bu deng tian
平步青云	ping bu qing yun
平民百姓	ping min bai xing
平淡无味	ping dan wu wei
平淡无奇	ping dan wu qi
平白无故	ping bai wu gu
平等互利	ping deng hu li
平起平坐	ping qi ping zuo
平铺直叙	ping pu zhi xu
年久失修	nian jiu shi xiu
年事已高	nian shi yi gao
年复一年	nian fu yi nian
年富力强	nian fu li qiang
年少无知	nian shao wu zhi
年少气盛	nian shao qi sheng
年幼无知	nian you wu zhi
年深日久	nian shen ri jiu
年老体弱	nian lao ti ruo
年老体衰	nian lao ti shuai
年老力衰	nian lao li shuai
年老色衰	nian lao se shuai
年轻力壮	nian qing li zhuang
年轻气盛	nian qing qi sheng
年逾古稀	nian yu gu xi
年高望重	nian gao wang zhong
并肩作战	bing jian zuo zhan
并行不悖	bing xing bu bei
并驾齐驱	bing jia qi qu
幸灾乐祸	xing zai le huo
广开言路	guang kai yan lu
广种薄收	guang zhong bo shou
应付自如	ying fu zi ru
应对如流	ying dui ru liu
应接不暇	ying jie bu xia
应有尽有	ying you jin you
应答如流	ying da ru liu
应运而生	ying yun er sheng
应运而起	ying yun er qi
庖丁解牛	pao ding jie niu
庞然大物	pang ran da wu
废寝忘食	fei qin wang shi
废寝忘餐	fei qin wang can
废物利用	fei wu li yong
废话连篇	fei hua lian pian
度日如年	du ri ru nian
座无空席	zuo wu kong xi
座无虚席	zuo wu xu xi
康庄大道	kang zhuang da dao
庸人自扰	yong ren zi rao
庸庸碌碌	yong yong lu lu
廉明公正	lian ming gong zheng
廉洁奉公	lian jie feng gong
延年益寿	yan nian yi shou
建功立业	jian gong li ye
开卷有益	kai juan you yi
开国元勋	kai guo yuan xun
开国功臣	kai guo gong chen
开天辟地	kai tian pi di
开宗明义	kai zong ming yi
开山之祖	kai shan zhi zu
开山始祖	kai shan shi zu
开山祖师	kai shan zu shi
开山鼻祖	kai shan bi zu
开怀畅饮	kai huan chang yin
开源节流	kai yuan jie liu
开疆拓土	kai jiang tuo tu
开疆辟土	kai jiang pi tu
开花结果	kai hua jie guo
开诚布公	kai cheng bu gong
开诚相见	kai cheng xiang jian
开足马力	kai zu ma li
开路先锋	kai lu xian feng
开门揖盗	kai men yi dao
开门见山	kai men jian shan
开阔眼界	kai kuo yan jie
异乎寻常	yi hu xun chang
异军突起	yi jun tu qi
异口同声	yi kou tong sheng
异想天开	yi xiang tian kai
异曲同工	yi qu tong gong
异端邪说	yi duan xie shuo
异途同归	yi tu tong gui
弃之可惜	qi zhi ke xi
弃恶从善	qi e cong shan
弃旧图新	qi jiu tu xin
弃旧迎新	qi jiu ying xin
弃暗投明	qi an tou ming
弃邪归正	qi xie gui zheng
弄假成真	nong jia cheng zhen
弄巧反拙	nong qiao fan zhuo
弄巧成拙	nong qiao cheng zhuo
弄虚作假	nong xu zuo jia
弊多利少	bi duo li shao
引人入胜	yin ren ru sheng
引人注目	yin ren zhu mu
引人瞩目	yin ren zhu mu
引以为憾	yin yi wei han
引以为戒	yin yi wei jie
引以为耻	yin yi wei chi
引以为荣	yin yi wei rong
引以自豪	yin yi zi hao
引入歧途	yin ru qi tu
引吭高歌	yin hang gao ge
引咎自责	yin jiu zi ze
引火烧身	yin huo shao shen
引狼入室	yin lang ru shi
引经据典	yin jing ju dian
引而不发	yin er bu fa
引蛇出洞	yin she chu dong
张三李四	zhang san li si
张冠李戴	zhang guan li dai
张口结舌	zhang kou jie she
张灯结彩	zhang deng jie cai
张牙舞爪	zhang ya wu zhao
张皇失措	zhang huang shi cuo
弥天大祸	mi tian da huo
弥天大罪	mi tian da zui
弥天大谎	mi tian da huang
弥留之际	mi liu zhi ji
弦外之意	xian wai zhi yi
弦外之音	xian wai zhi yin
弱不禁风	ruo bu jin feng
弱势群体	ruo shi qun ti
弱肉强食	ruo rou qiang shi
弹丸之地	dan wan zhi di
弹尽援绝	dan jin yuan jue
弹尽粮绝	dan jin liang jue
弹指之间	tan zhi zhi jian
弹无虚发	dan wu xu fa
强买强卖	qiang mai qiang mai
强人所难	qiang ren suo nan
强加于人	qiang jia yu ren
强取豪夺	qiang qu hao duo
强弩之末	qiang nu zhi mo
强词夺理	qiang ci duo li
强颜欢笑	qiang yan huan xiao
归心似箭	gui xin si jian
归根到底	gui gen dao di
归根究柢	gui gen jiu di
归根结底	gui gen jie di
归根结蒂	gui gen jie di
当之无愧	dang zhi wu kui
当之有愧	dang zhi you kui
当仁不让	dang ren bu rang
当务之急	dang wu zhi ji
当场出丑	dang chang chu chou
当头一棒	dang tou yi bang
当头棒喝	dang tou bang he
当家作主	dang jia zuo zhu
当家做主	dang jia zuo zhu
当局者迷	dang ju zhe mi
当断不断	dang duan bu duan
当机立断	dang ji li duan
当耳旁风	dang er pang feng
当耳边风	dang er bian feng
当面出丑	dang mian chu chou
形势逼人	xing shi bi ren
形单影只	xing dan ying zhi
形容憔悴	xing rong qiao cui
形式主义	xing shi zhu yi
形形色色	xing xing se se
形影不离	xing ying bu li
形影相依	xing ying xiang yi
形影相吊	xing ying xiang diao
形影相随	xing ying xiang sui
形神兼备	xing shen jian bei
形而上学	xing er shang xue
形迹可疑	xing ji ke yi
彪形大汉	biao xing da han
彬彬有礼	bin bin you li
彻头彻尾	che tou che wei
彼此彼此	bi ci bi ci
待人接物	dai ren jie wu
待价而沽	dai jia er gu
徇私枉法	xun si wang fa
徇私舞弊	xun si wu bi
徐娘半老	xu niang ban lao
徒劳无功	tu lao wu gong
徒劳无益	tu lao wu yi
徒子徒孙	tu zi tu sun
徒有其名	tu you qi ming
徒有其表	tu you qi biao
徒有虚名	tu you xu ming
得不偿失	de bu chang shi
得天独厚	de tian du hou
得失参半	de shi can ban
得寸入尺	de cun ru chi
得寸进尺	de cun jin chi
得心应手	de xin ying shou
得意之作	de yi zhi zuo
得意之色	de yi zhi se
得意忘形	de yi wang xing
得意扬扬	de yi yang yang
得意洋洋	de yi yang yang
得意门生	de yi men sheng
得而复失	de er fu shi
得过且过	de guo qie guo
得道多助	de dao duo zhu
得陇望蜀	de long wang shu
徘徊不前	pai huai bu qian
徘徊不定	pai huai bu ding
徘徊观望	pai huai guan wang
御用文人	yu yong wen ren
循序渐进	xun xu jian jin
循循善诱	xun xun shan you
循环往复	xun huan wang fu
循规蹈矩	xun gui dao ju
微不足道	wei bu zu dao
微乎其微	wei hu qi wei
微言大义	wei yan da yi
德才兼备	de cai jian bei
德艺双馨	de yi shuang xin
德高望重	de gao wang zhong
心不在焉	xin bu zai yan
心中无数	xin zhong wu shu
心中有数	xin zhong you shu
心乱如麻	xin luan ru ma
心事重重	xin shi chong chong
心仪已久	xin yi yi jiu
心力交瘁	xin li jiao cui
心力衰竭	xin li shuai jie
心口不一	xin kou bu yi
心口如一	xin kou ru yi
心向往之	xin xiang wang zhi
心地善良	xin di shan liang
心如刀割	xin ru dao ge
心如刀绞	xin ru dao jiao
心如止水	xin ru zhi shui
心如死灰	xin ru si hui
心如铁石	xin ru tie shi
心存芥蒂	xin cun jie di
心安理得	xin an li de
心宽体胖	xin kuan ti pan
心平气和	xin ping qi he
心广体胖	xin guang ti pan
心心念念	xin xin nian nian
心心相印	xin xin xiang yin
心怀叵测	xin huai po ce
心怀忐忑	xin huai tan te
心怀鬼胎	xin huai gui tai
心急如火	xin ji ru huo
心急如焚	xin ji ru fen
心急火燎	xin ji huo liao
心悦诚服	xin yue cheng fu
心惊肉跳	xin jing rou tiao
心惊胆寒	xin jing dan han
心惊胆战	xin jing dan zhan
心惊胆颤	xin jing dan chan
心慈手软	xin ci shou ruan
心慌意乱	xin huang yi luan
心无二用	xin wu er yong
心无城府	xin wu cheng fu
心无旁骛	xin wu pang wu
心旷神怡	xin kuang shen yi
心明眼亮	xin ming yan liang
心有余悸	xin you yu ji
心有灵犀	xin you ling xi
心服口服	xin fu kou fu
心术不正	xin shu bu zheng
心术不端	xin shu bu duan
心比天高	xin bi tian gao
心浮气躁	xin fu qi zao
心满意足	xin man yi zu
心潮澎湃	xin chao peng pai
心灰意冷	xin hui yi leng
心灰意懒	xin hui yi lan
心灵手巧	xin ling shou qiao
心烦意乱	xin fan yi luan
心焦如焚	xin jiao ru fen
心照不宣	xin zhao bu xuan
心狠手毒	xin hen shou du
心狠手辣	xin hen shou la
心猿意马	xin yuan yi ma
心甘情愿	xin gan qing yuan
心直口快	xin zhi kou kuai
心直嘴快	xin zhi zui kuai
心神不宁	xin shen bu ning
心神不安	xin shen bu an
心神不定	xin shen bu ding
心神恍惚	xin shen huang hu
心绪不宁	xin xu bu ning
心肝宝贝	xin gan bao bei
心胆俱裂	xin dan ju lie
心胸开阔	xin xiong kai kuo
心胸狭隘	xin xiong xia ai
心腹之患	xin fu zhi huan
心腹大患	xin fu da huan
心花怒放	xin hua nu fang
心血来潮	xin xue lai chao
心醉神迷	xin zui shen mi
心里有鬼	xin li you gui
心领神会	xin ling shen hui
心驰神往	xin chi shen wang
心高气傲	xin gao qi ao
必不可少	bi bu ke shao
必争之地	bi zheng zhi di
必恭必敬	bi gong bi jing
必由之路	bi you zhi lu
必经之路	bi jing zhi lu
忆苦思甜	yi ku si tian
忍俊不禁	ren jun bu jin
忍无可忍	ren wu ke ren
忍气吞声	ren qi tun sheng
忍痛割爱	ren tong ge ai
忍辱偷生	ren ru tou sheng
忍辱负重	ren ru fu zhong
忍饥挨饿	ren ji ai e
忐忑不安	tan te bu an
志同道合	zhi tong dao he
志在千里	zhi zai qian li
志在四方	zhi zai si fang
志在必得	zhi zai bi de
志士仁人	zhi shi ren ren
志大才疏	zhi da cai shu
志存高远	zhi cun gao yuan
志得意满	zhi de yi man
忘乎所以	wang hu suo yi
忘年之交	wang nian zhi jiao
忘恩负义	wang en fu yi
忙中有序	mang zhong you xu
忙中有错	mang zhong you cuo
忙忙碌碌	mang mang lu lu
忙里偷闲	mang li tou xian
忠于职守	zhong yu zhi shou
忠心耿耿	zhong xin geng geng
忠肝义胆	zhong gan yi dan
忠言逆耳	zhong yan ni er
忠诚不渝	zhong cheng bu yu
忠贞不二	zhong zhen bu er
忠贞不屈	zhong zhen bu qu
忠贞不渝	zhong zhen bu yu
忧国忧民	you guo you min
忧心如焚	you xin ru fen
忧心忡忡	you xin chong chong
快人快语	kuai ren kuai yu
快言快语	kuai yan kuai yu
快马加鞭	kuai ma jia bian
念念不忘	nian nian bu wang
念念有词	nian nian you ci
忸忸怩怩	niu niu ni ni
忸怩不安	niu ni bu an
忽冷忽热	hu leng hu re
忽隐忽现	hu yin hu xian
忿忿不平	fen fen bu ping
怀恨在心	huai hen zai xin
怀才不遇	huai cai bu yu
怅然若失	chang ran ruo shi
怒不可遏	nu bu ke e
怒发冲冠	nu fa chong guan
怒容满面	nu rong man mian
怒形于色	nu xing yu se
怒气冲冲	nu qi chong chong
怒气冲天	nu qi chong tian
怒火中烧	nu huo zhong shao
怒火冲天	nu huo chong tian
怒目相视	nu mu xiang shi
怒目而视	nu mu er shi
怜香惜玉	lian xiang xi yu
思前想后	si qian xiang hou
思前虑后	si qian lu hou
思绪万千	si xu wan qian
怡然自乐	yi ran zi le
怡然自得	yi ran zi de
急不可待	ji bu ke dai
急不可耐	ji bu ke nai
急不择言	ji bu ze yan
急不择路	ji bu ze lu
急中生智	ji zhong sheng zhi
急于求成	ji yu qiu cheng
急公好义	ji gong hao yi
急功近利	ji gong jin li
急如星火	ji ru xing huo
急急忙忙	ji ji mang mang
急流勇进	ji liu yong jin
急流勇退	ji liu yong tui
急起直追	ji qi zhi zhui
急转直下	ji zhuan zhi xia
急风暴雨	ji feng bao yu
急风骤雨	ji feng zhou yu
怦然心动	peng ran xin dong
性命攸关	xing ming you guan
性情中人	xing qing zhong ren
怨声载道	yuan sheng zai dao
怨天尤人	yuan tian you ren
怨气冲天	yuan qi chong tian
怪声怪气	guai sheng guai qi
怪模怪样	guai mo guai yang
怪腔怪调	guai qiang guai diao
怪里怪气	guai li guai qi
总而言之	zong er yan zhi
恃强凌弱	shi qiang ling ruo
恃强欺弱	shi qiang qi ruo
恃才傲物	shi cai ao wu
恋恋不舍	lian lian bu she
恍如隔世	huang ru ge shi
恍恍惚惚	huang huang hu hu
恍然大悟	huang ran da wu
恍若隔世	huang ruo ge shi
恢宏大度	hui hong da du
恣意妄为	zi yi wang wei
恨之入骨	hen zhi ru gu
恩威并济	en wei bing ji
恩威并用	en wei bing yong
恩威并行	en wei bing xing
恩威并重	en wei bing zhong
恩将仇报	en jiang chou bao
恩怨分明	en yuan fen ming
恩恩怨怨	en en yuan yuan
恩恩爱爱	en en ai ai
恩断义绝	en duan yi jue
恩爱夫妻	en ai fu qi
恩重如山	en zhong ru shan
恬不知耻	tian bu zhi chi
恭喜发财	gong xi fa ca
恭恭敬敬	gong gong jing jing
恭贺新禧	gong he xin xi
息事宁人	xi shi ning ren
息息相关	xi xi xiang guan
息息相通	xi xi xiang tong
恰中要害	qia zhong yao hai
恰到好处	qia dao hao chu
恰如其分	qia ru qi fen
恶声恶气	e sheng e qi
恶性循环	e xing xun huan
恶意中伤	e yi zhong shang
恶有恶报	e you e bao
恶言恶语	e yan e yu
恶语中伤	e yu zhong shang
恶语伤人	e yu shang ren
恶语相加	e yu xiang jia
恶贯满盈	e guan man ying
恻隐之心	ce yin zhi xin
恼羞成怒	nao xiu cheng nu
悄无声息	qiao wu sheng xi
悄然无声	qiao ran wu sheng
悉听尊便	xi ting zun bian
悍然不顾	han ran bu gu
悔不当初	hui bu dang chu
悔之不及	hui zhi bu ji
悔之无及	hui zhi wu ji
悔之莫及	hui zhi mo ji
悔恨交加	hui hen jiao jia
悔过自新	hui guo zi xin
悔过自责	hui guo zi ze
悠哉游哉	you zai you zai
悠悠自得	you you zi de
悠游自在	you you zi zai
悠然自得	you ran zi de
悠闲自在	you xian zi zai
患得患失	huan de huan shi
患难与共	huan nan yu gong
患难之交	huan nan zhi jiao
患难夫妻	huan nan fu qi
悬崖勒马	xuan ya le ma
悬崖峭壁	xuan ya qiao bi
悬崖绝壁	xuan ya jue bi
悬梁刺股	xuan liang ci gu
悬而未决	xuan er wei jue
悲喜交加	bei xi jiao jia
悲喜交集	bei xi jiao ji
悲天悯人	bei tian min ren
悲愤填膺	bei fen tian ying
悲欢离合	bei huan li he
悲痛欲绝	bei tong yu jue
悲观厌世	bei guan yan shi
悲观失望	bei guan shi wang
情不自禁	qing bu zi jin
情同手足	qing tong shou zu
情意绵绵	qing yi mian mian
情投意合	qing tou yi he
情景交融	qing jing jiao rong
情有可原	qing you ke yuan
情有独钟	qing you du zhong
情深义重	qing shen yi zhong
情深似海	qing shen si hai
情深意重	qing shen yi zhong
情理难容	qing li nan rong
情真意切	qing zhen yi qie
情窦初开	qing dou chu kai
情非得已	qing fei de yi
惊世骇俗	jing shi hai su
惊人之举	jing ren zhi ju
惊叹不已	jing tan bu yi
惊喜交加	jing xi jiao jia
惊喜交集	jing xi jiao ji
惊喜若狂	jing xi ruo kuang
惊天动地	jing tian dong di
惊弓之鸟	jing gong zhi niao
惊心动魄	jing xing dong po
惊恐万状	jing kong wan zhuang
惊惶不安	jing huang bu an
惊惶失措	jing huang shi cuo
惊惶失色	jing huang shi se
惊慌失措	jing huang shi cuo
惊慌失色	jing huang shi se
惊涛骇浪	jing tao hai lang
惊魂不定	jing hun bu ding
惊魂未定	jing hun wei ding
惘然若失	wang ran ruo shi
惜墨如金	xi mo ru jin
惜字如金	xi zi ru jin
惟利是图	wei li shi tu
惟命是从	wei ming shi cong
惟妙惟肖	wei miao wei xiao
惟我独尊	wei wo du zun
惨不忍睹	can bu ren du
惨不忍闻	can bu ren wen
惨无人道	can wu ren dao
惨淡经营	can dan jing ying
惨绝人寰	can jue ren huan
惨遭不幸	can zao bu xing
惩一儆百	cheng yi jing bai
惩一警百	cheng yi jing bai
惩前毖后	cheng qian bi hou
想入非非	xiang ru fei fei
想方设法	xiang fang she fa
惴惴不安	zhui zhui bu an
惶恐不安	huang kong bu an
惶惶不安	huang huang bu an
惹事生非	re shi sheng fei
惹人注目	re ren zhu mu
惹是生非	re shi sheng fei
惹火上身	re huo shang shen
惹火烧身	re huo shao shen
惺惺作态	xing xing zuo tai
惺惺相惜	xing xing xiang xi
愁眉不展	chou mei bu zhan
愁眉苦脸	chou mei ku lian
愁肠寸断	chou chang cun duan
意味深长	yi wei shen chang
意在言外	yi zai yan wai
意外之财	yi wai zhi cai
意想不到	yi xiang bu dao
意料之外	yi liao zhi wai
意气用事	yi qi yong shi
意气相投	yi qi xiang tou
意气风发	yi qi feng fa
意犹未尽	yi you wei jin
愚不可及	yu bu ke ji
愚公移山	yu gong yi shan
愚昧无知	yu mei wu zhi
感人肺腑	gan ren fei fu
感人至深	gan ren zhi shen
感同身受	gan tong shen shou
感天动地	gan tian dong di
感恩图报	gan en tu bao
感恩戴德	gan en dai de
感情用事	gan qing yong shi
感慨万千	gan kai wan qian
感激不尽	gan ji bu jin
感激涕零	gan ji ti ling
愣头呆脑	leng tou dai nao
愣头愣脑	leng tou leng nao
愤世嫉俗	fen shi ji su
愤愤不平	fen fen bu ping
愧不敢当	kui bu gan dang
慈悲为怀	ci bei wei huai
慈眉善目	ci mei shan mu
慈眉善眼	ci mei shan yan
慌不择路	huang bu ze lu
慌作一团	huang zuo yi tuan
慌张失措	huang zhang shi cuo
慌慌张张	huang huang zhang zhang
慌手慌脚	huang shou huang jiao
慌里慌张	huang li huang zhang
慎言慎行	shen yan shen xing
慕名而来	mu ming er lai
慢声细语	man sheng xi yu
慢慢吞吞	man man tun tun
慢慢腾腾	man man teng teng
慢条斯理	man tiao si li
慧眼独具	hui yan du ju
慷慨仗义	kang kai zhang yi
慷慨就义	kang kai jiu yi
慷慨激昂	kang kai ji ang
慷慨解囊	kang kai jie nang
慷慨陈词	kang kai chen ci
憨态可掬	han tai ke ju
懊悔莫及	ao hui mo ji
懵头转向	meng tou zhuan xiang
懵懵懂懂	meng meng dong dong
戎马生涯	rong ma sheng ya
成人之美	cheng ren zhi mei
成何体统	cheng he ti tong
成千上万	cheng qian shang wan
成千成万	cheng qian cheng wan
成双成对	cheng shuang cheng dui
成名成家	cheng ming cheng jia
成家立业	cheng jia li yie
成年累月	cheng nian lei yue
成王败寇	cheng wang bai kou
成竹在胸	cheng zhu zai xiong
成群结伙	cheng qun jie huo
成群结队	cheng qun jie dui
成败得失	cheng bai de shi
成龙配套	cheng long pei tao
我行我素	wo xing wo su
戒备森严	jie bei sen yan
戒骄戒躁	jie jiao jie zao
战战兢兢	zhan zhan jing jing
战无不胜	zhan wu bu sheng
战火纷飞	zhan huo fen fei
戛然而止	jia ran er zhi
截然不同	jie ran bu tong
截长补短	jie chang bu duan
戳脊梁骨	chuo ji liang gu
戴绿帽子	dai lu mao zi
戴罪立功	dai zui li gong
戴高帽子	dai gao mao zi
所作所为	suo zuo suo wei
所到之处	suo dao zhi chu
所剩无几	suo sheng wu ji
所向披靡	suo xiang pi mi
所向无敌	suo xiang wu di
所见所闻	suo jian suo wen
所见略同	suo jian lue tong
手下留情	shou xia liu qing
手不释卷	shou bu shi juan
手到拈来	shou dao nian lai
手到擒来	shou dao qin lai
手到病除	shou dao bing chu
手忙脚乱	shou mang jiao luan
手急眼快	shou ji yan kuai
手慌脚乱	shou huang jiao luan
手无寸铁	shou wu cun tie
手疾眼快	shou ji yan kuai
手眼通天	shou yan tong tian
手舞足蹈	shou wu zu dao
手起刀落	shou qi dao luo
手足之情	shou zu zhi qing
手足无措	shou zu wu cuo
才华横溢	cai hua heng yi
才华盖世	cai hua gai shi
才子佳人	cai zi jia ren
才德兼备	cai de jian bei
才气过人	cai qi guo ren
才疏学浅	cai shu xue qian
才疏识浅	cai shu shi qian
才识过人	cai shi guo ren
才貌双全	cai mao shuang quan
才高八斗	cai gao ba dou
扎扎实实	zha zha shi shi
扑朔迷离	pu shuo mi li
打乱阵脚	da luan zhen jiao
打入冷宫	da ru leng gong
打击报复	da ji bao fu
打定主意	da ding zhu yi
打家劫舍	da jia jie she
打小报告	da ru leng gong
打小算盘	da xiao suan pan
打得火热	da de huo re
打情骂俏	da qing ma qiao
打成一片	da cheng yi pian
打成平手	da cheng ping shou
打打闹闹	da da nao nao
打抱不平	da bao bu ping
打破常规	da po chang gui
打破陈规	da po chen gui
打草惊蛇	da cao jing she
打落水狗	da luo shui gou
打退堂鼓	da tui tang gu
打道回府	da dao hui fu
打铁趁热	da tie chen re
打马虎眼	da ma hu yan
扣人心弦	kou ren xin xian
执法如山	zhi fa ru shan
执法犯法	zhi fa fan fa
执迷不悟	zhi mi bu wu
扪心自问	men xin zi wen
扫地出门	sao di chu men
扬名四海	yang ming si hai
扬扬得意	yang yang de yi
扬扬自得	yang yang zi de
扬汤止沸	yang tang zhi fei
扬眉吐气	yang mei tu qi
扬长而去	yang chang er qu
扬长避短	yang chang bi duan
扭亏为盈	niu kui wei ying
扭扭捏捏	niu niu nie nie
扭捏作态	niu nie zuo tai
扭转乾坤	niu zhuan qian kun
扶危济困	fu wei ji kun
扶摇直上	fu yao zhi shang
扶正祛邪	fu zheng qu xie
扶老携幼	fu lao xie you
扼腕叹息	e wan tan xi
承上启下	cheng shang qi xia
承先启后	cheng xian qi hou
承前启后	cheng qian qi hou
把持不住	ba chi bu zhu
抑强扶弱	yi qiang fu ruo
抑扬顿挫	yi yang dun cuo
抓小辫子	zhua xiao bian zi
抓耳挠腮	zhua er nao sai
投亲靠友	tou qin kao you
投其所好	tou qi suo hao
投怀送抱	tou huai song bao
投机倒把	tou ji dao ba
投机取巧	tou ji qu qiao
投桃报李	tou tao bao li
投石问路	tou shi wen lu
投笔从戎	tou bi cong rong
投鼠忌器	tou shu ji qi
抖擞精神	dou sou jing shen
抚掌大笑	fu zhang da xiao
抛头露面	pao tou lu mian
抛妻弃子	pao qi qi zi
抛砖引玉	pao zhuan yin yu
报仇雪恨	bao chou xue hen
报仇雪耻	bao chou xue chi
报应不爽	bao ying bu shuang
披头散发	pi tou san fa
披星戴月	pi xing dai yue
披沙拣金	pi sha jian jin
披肝沥胆	pi gan li dan
披荆斩棘	pi jing zhan ji
披麻戴孝	pi ma dai xiao
抱头大哭	bao tou da ku
抱头痛哭	bao tou tong ku
抱头鼠窜	bao tou shu cuan
抱成一团	bao cheng yi tuan
抱打不平	bao da bu ping
抱残守缺	bao can shou que
抱薪救火	bao xin jiu huo
抽丝剥茧	chou si bao jian
拂袖而去	fu xiu er qu
担惊受怕	dan jing shou pa
拆东补西	chai dong bu xi
拈花惹草	nian hua re cao
拈轻怕重	nian qing pa zhong
拉不下脸	la bu xia lian
拉人下水	la ren xia shui
拉家带口	la jia dai kou
拉帮结伙	la bang jie huo
拉帮结派	la bang jie pai
拉拉扯扯	la la che che
拍手叫好	pai shou jiao hao
拍手称快	pai shou cheng kuai
拍板定案	pai ban ding an
拍板成交	pai ban cheng jiao
拍案叫绝	pai an jiao jue
拍案而起	pai an er qi
拐弯抹角	guai wan mo jiao
拒之门外	ju zhi men wai
拒人千里	ju ren qian li
拔刀相助	ba dao xiang zhu
拔刀相向	ba dao xiang xiang
拔苗助长	ba miao zhu zhang
拖人下水	tuo ren xia shui
拖儿带女	tuo er dai nu
拖家带口	tuo jia dai kou
拖拖拉拉	tuo tuo la la
拖泥带水	tuo ni dai shui
拙嘴笨舌	zhuo zui ben she
招兵买马	zhao bing mai ma
招摇撞骗	zhao yao zhuang pian
招摇过市	zhao yao guo shi
招架不住	zhao jia bu zhu
招灾惹祸	zhao zai re huo
招花惹草	zhao hua re cao
招蜂引蝶	zhao feng yin die
招财进宝	zhao cai jin bao
招贤纳士	zhao xian na shi
拨乱反正	bo luan fan zheng
拨云见日	bo yun jian ri
择优录取	ze you lu qu
择优录用	ze you lu yong
择善而从	ze shan er cong
拭目以待	shi mu yi dai
拭目而待	shi mu er dai
拱手让人	gong shou rang ren
拳不离手	quan bu li shou
拳头产品	quan tou chan pin
拳打脚踢	quan da jiao ti
拼死拼活	pin si pin huo
拾金不昧	shi jin bu mei
拿不出手	na bu chu shou
拿手好戏	na shou hao xi
拿腔作势	na qiang zuo shi
持之以恒	chi zhi yi heng
挂一漏万	gua yi lou wan
挂灯结彩	gua deng jie cai
指东打西	zhi dong da xi
指名道姓	zhi ming dao xing
指手划脚	zhi shou hua jiao
指手画脚	zhi shou hua jiao
指指点点	zhi zhi dian dian
指日可待	zhi ri ke dai
指桑骂槐	zhi sang ma huai
指点江山	zhi dian jiang shan
指鹿为马	zhi lu wei ma
按兵不动	an bing bu dong
按劳分配	an lao fen pei
按图索骥	an tu suo ji
按捺不住	an na bu zhu
按步就班	an bu jiu ban
按部就班	an bu jiu ban
挑三拣四	tiao san jian si
挑唆是非	tiao suo shi fei
挑拨离间	tiao bo li jian
挑挑拣拣	tiao tiao jian jian
挑肥拣瘦	tiao fei jian shou
挖空心思	wa kong xin si
挤眉弄眼	ji mei nong yan
挥汗如雨	hui han ru yu
挥洒自如	hui sa zi ru
挥金如土	hui jin ru tu
挥霍无度	hui huo wu du
挨家挨户	ai jia ai hu
挨门挨户	ai men ai hu
挨门逐户	ai men zhu hu
挨饿受冻	ai e shou dong
振奋人心	zhen fen ren xin
振振有词	zhen zhen you ci
振振有辞	zhen zhen you ci
振聋发聩	zhen long fa kui
振臂一呼	zhen bi yi hu
挺身而出	ting shen er chu
捅马蜂窝	tong ma feng wo
捉摸不定	zhuo mo bu ding
捉襟见肘	zhuo jin jian zhou
捉贼捉赃	zhuo zei zhuo zang
捏一把汗	nie yi ba han
捐弃前嫌	juan qi qian xian
捕风捉影	bu feng zhuo ying
损人利己	sun ren li ji
损公肥私	sun gong fei si
损兵折将	sun bing zhe jiang
捧腹大笑	peng fu da xiao
据为己有	ju wei ji you
据理力争	ju li li zheng
捶胸顿足	chui xiong dun zu
捷报频传	jie bao pin chuan
捷足先登	jie zu xian deng
授业解惑	shou ye jie huo
授人以柄	shou ren yi bing
掉以轻心	diao yi qing xin
掌上明珠	zhang shang ming zhu
掌声雷动	zhang sheng lei dong
掐头去尾	qia tou qu wei
排山倒海	pai shan dao hai
排忧解难	pai you jie nan
排斥异己	pai chi yi ji
排除万难	pai chu wan nan
排除异己	pai chu yi ji
探囊取物	tan nang qu wu
探头探脑	tan tou tan nao)
接二连三	jie er lian san
接踵而来	jie zhong er lai
接踵而至	jie zhong er zhi
接连不断	jie lian bu duan
推三阻四	tui san zu si
推崇备至	tui chong bei zhi
推己及人	tui ji ji ren
推心置腹	tui xin zhi fu
推推搡搡	tui tui sang sang
推波助澜	tui bo zhu lan
推而广之	tui er guang zhi
推陈出新	tui chen chu xin
掩人耳目	yan ren er mu
掩耳偷铃	yan er tou ling
掩耳盗铃	yan er dao ling
掩面而泣	yan mian er qi
措手不及	cuo shou bu ji
掷地有声	zhi di you sheng
提心吊胆	ti xin diao dan
提纲挈领	ti gang qie ling
插科打诨	cha ke da hun
插翅难逃	cha chi nan tao
插翅难飞	cha chi nan fei
揠苗助长	ya miao zhu zhang
握手言欢	wo shou yan huan
揭不开锅	jie bu kai guo
揭竿而起	jie gan er qi
搔首弄姿	sao shou nong zi
搜肠刮肚	sou chang gua du
搬弄是非	ban nong shi fei
携家带口	xie jia dai kou
携手并肩	xie shou bing jian
搽脂抹粉	cha zhi mo fen
摆老资格	bai lao zi ge
摇头叹息	yao tou tan xi
摇头摆尾	yao tou bai wei
摇头晃脑	yao tou huang nao
摇尾乞怜	yao wei qi lian
摇摆不定	yao bai bu ding
摇摇摆摆	yao yao bai bai
摇摇欲坠	yao yao yu zhui
摇旗呐喊	yao qi na han
摇曳多姿	yao ye duo zi
摇身一变	yao shen yi bian
摧枯拉朽	cui ku la xiu
摩拳擦掌	mo quan ca zhang
摩肩接踵	mo jian jie zhong
摩肩擦踵	mo jian ca zhong
摸棱两可	mo leng liang ke
撒泼打滚	sa po da gun
播弄是非	bo nong shi fei
撼天动地	han tian dong di
擅离职守	shan li zhi shou
操之过急	cao zhi guo ji
擒贼擒王	qin zei qin wang
擦亮眼睛	ca liang yan jing
擦肩而过	ca jian er guo
擦脂抹粉	ca zhi mo fen
攀龙附凤	pan long fu feng
支吾其词	zhi wu qi ci
支吾其辞	zhi wu qi ci
支支吾吾	zhi zhi wu wu
支离破碎	zhi li po sui
收买人心	shou mai ren xin
改名换姓	gai ming huan xing
改天换地	gai tian huan di
改头换面	gai tou huan mian
改弦易辙	gai xian yi zhe
改弦更张	gai xian geng zhang
改恶从善	gai e cong shan
改恶向善	gai e xiang shan
改朝换代	gai chao huan dai
改过自新	gai guo zi xin
改邪归正	gai xie gui zheng
攻其不备	gong qi bu bei
攻城掠地	gong cheng lue di
攻城略地	gong cheng lue di
攻守同盟	gong shou tong meng
攻无不克	gong wu bu ke
放下包袱	fang xia bao fu
放下屠刀	fang xia tu dao
放任自流	fang ren zi liu
放浪不羁	fang lang bu ji
放烟幕弹	fang yan mu dan
放眼世界	fang yan shi jie
放纵不羁	fang zong bu ji
放荡不羁	fang dang bu ji
放虎归山	fang hu gui shan
放马后炮	fang ma hou pao
政通人和	zheng tong ren he
故伎重演	gu ji zhong yan
故作姿态	gu zuo zi tai
故作玄虚	gu zuo xuan xu
故作镇静	gu zuo zhen jing
故作高深	gu zuo gao shen
故土难离	gu tu nan li
故地重游	gu di chong you
故弄玄虚	gu nong xuan xu
故态复萌	gu tai fu meng
故意刁难	gu yi diao nan
故技重演	gu ji chong yan
故步自封	gu bu zi feng
敌众我寡	di zhong wo gua
敏而好学	min er hao xue
救亡图存	jiu wang tu cun
救命稻草	jiu ming dao cao
救死扶伤	jiu si fu shang
救苦救难	jiu ku jiu nan
教学相长	jiao xue xiang zhang
教导有方	jiao dao you fang
教条主义	jiao tiao zhu yi
敝帚自珍	bi zhou zi zhen
敢作敢为	gan zuo gan wei
敢作敢当	gan zuo gan dang
敢做敢为	gan zuo gan wei
敢做敢当	gan zuo gan dang
敢想敢干	gan xiang gan gan
敢想敢说	gan xiang gan shuo
散兵游勇	san bing you yong
敬老尊贤	jing lao zun xian
敬老爱幼	jing lao ai you
敬而远之	jing er yuan zhi
数一数二	shu yi shu er
数不胜数	shu bu sheng shu
数九寒天	shu jiu han tian
数以万计	shu yi wan ji
数典忘祖	shu dian wang zu
数罪并罚	shu zui bing fa
数见不鲜	shuo jian bu xian
敲山震虎	qiao shan zhen hu
敲诈勒索	qiao zha le suo
敲锣打鼓	qiao luo da gu
整整齐齐	zheng zheng qi qi
整装待发	zheng zhuang dai fa
整齐划一	zheng qi hua yi
敷衍了事	fu yan liao shi
敷衍塞责	fu yan se ze
敷衍搪塞	fu yan tang se
文不对题	wen bu dui ti
文人墨客	wen ren mo ke
文人相轻	wen ren xiang qing
文人雅士	wen ren ya shi
文如其人	wen ru qi ren
文山会海	wen shan hui hai
文弱书生	wen ruo shu sheng
文思敏捷	wen si min jie
文情并茂	wen qing bing mao
文房四宝	wen fang si bao
文武全才	wen wu quan cai
文武兼备	wen wu jian bei
文武双全	wen wu shuang quan
文理不通	wen li bu tong
文笔流畅	wen bi liu chang
文质彬彬	wen zhi bin bin
文过饰非	wen guo shi fei
文韬武略	wen tao wu lue
斗志昂扬	dou zhi ang yang
斗转星移	dou zhuan xing yi
料事如神	liao shi ru shen
斜风细雨	xie feng xi yu
斤斤计较	jin jin ji jiao
斩尽杀绝	zhan jin sha jue
斩草除根	zhan cao chu gen
斩钉截铁	zhan ding jie tie
断壁残垣	duan bi can yuan
断断续续	duan duan xu xu
断然措施	duan ran cuo shi
断章取义	duan zhang qu yi
斯文扫地	si wen sao di
新仇旧恨	xin chou jiu hen
新来乍到	xin lai zha dao
新陈代谢	xin chen dai xie
方便之门	fang bian zhi men
方兴未艾	fang xing wei ai
方寸之地	fang cun zhi di
方方面面	fang fang mian mian
旁征博引	pang zheng bo yin
旁敲侧击	pang qiao ce ji
旁枝末节	pang zhi mo jie
旁若无人	pang ruo wu ren
旁观者清	pang guan zhe qing
旁门左道	pang men zuo dao
旁门歪道	pang men wai dao
旁门邪道	pang men xie dao
旗帜鲜明	qi zhi xian ming
旗开得胜	qi kai de sheng
旗鼓相当	qi gu xiang dang
无一是处	wu yi shi chu
无与伦比	wu yu lun bi
无业游民	wu ye you min
无中生有	wu zhong sheng you
无为而治	wu wei er zhi
无事生非	wu shi sheng fei
无亲无故	wu qin wu gu
无人不晓	wu ren bu xiao
无人不知	wu ren bu zhi
无人之境	wu ren zhi jing
无人问津	wu ren wen jin
无从下手	wu cong xia shou
无从说起	wu cong shuo qi
无以复加	wu yi fu jia
无价之宝	wu jia zhi bao
无休无止	wu xiu wu zhi
无伤大体	wu shang da ti
无伤大雅	wu shang da ya
无依无靠	wu yi wu kao
无关大局	wu guan da ju
无关痛痒	wu guan tong yang
无关紧要	wu guan jin yao
无凭无据	wu ping wu ju
无出其右	wu chu qi you
无利可图	wu li ke tu
无功受禄	wu gong shou lu
无功而返	wu gong er fan
无动于衷	wu dong yu zhong
无可争辩	wu ke zheng bian
无可厚非	wu ke hou fei
无可否认	wu ke fou ren
无可奈何	wu ke nai he
无可奉告	wu ke feng gao
无可救药	wu ke jiu yao
无可比拟	wu ke bi ni
无可置疑	wu ke zhi yi
无可置辩	wu ke zhi bian
无可讳言	wu ke hui yan
无可辩驳	wu ke bian bo
无可非议	wu ke fei yi
无名之辈	wu ming zhi bei
无名小卒	wu ming xiao zu
无名小辈	wu ming xiao bei
无名英雄	wu ming ying xiong
无名鼠辈	wu ming shu bei
无地自容	wu di zi rong
无坚不摧	wu jian bu cui
无声无息	wu sheng wu xi
无奇不有	wu qi bu you
无妄之灾	wu wang zhi zai
无孔不入	wu kong bu ru
无家可归	wu jia ke gui
无师自通	wu shi zi tong
无庸置疑	wu yong zhi yi
无形之中	wu xing zhi zhong
无影无踪	wu ying wu zong
无往不利	wu wang bu li
无往不胜	wu wang bu sheng
无微不至	wu wei bu zhi
无心之过	wu xin zhi guo
无心恋战	wu xin lian zhan
无忧无虑	wu you wu lu
无恶不作	wu e bu zuo
无情无义	wu qing wu yi
无懈可击	wu xie ke ji
无所不为	wu suo bu wei
无所不包	wu suo bu bao
无所不在	wu suo bu zai
无所不晓	wu suo bu xiao
无所不有	wu suo bu you
无所不知	wu suo bu zhi
无所不能	wu suo bu neng
无所不至	wu suo bu zhi
无所不谈	wu suo bu tan
无所事事	wu suo shi shi
无所作为	wu suo zuo wei
无所忌惮	wu suo ji dan
无所畏惧	wu suo wei ju
无所适从	wu suo shi cong
无所顾忌	wu suo gu ji
无拘无束	wu ju wu shu
无时无刻	wu shi wu ke
无暇顾及	wu xia gu ji
无法无天	wu fa wu tian
无济于事	wu ji yu shi
无牵无挂	wu qian wu gua
无独有偶	wu du you ou
无理取闹	wu li qu nao
无疾而终	wu ji er zhong
无病呻吟	wu bing shen yin
无的放矢	wu di fang shi
无私无畏	wu si wu wei
无稽之谈	wu ji zhi tan
无穷无尽	wu qiong wu jin
无米之炊	wu mi zhi chui
无精打采	wu jing da cai
无缘无故	wu yuan wu gu
无耻下流	wu chi xia liu
无耻之徒	wu chi zhi tu
无能为力	wu neng wei li
无能之辈	wu neng zhi bei
无补于事	wu bu yu shi
无言以对	wu yan yi dui
无计可施	wu ji ke shi
无论如何	wu lun ru he
无话不谈	wu hua bu tan
无足挂齿	wu zu gua chi
无足轻重	wu zu qing zhong
无路可走	wu lu ke zou
无踪无影	wu zong wu ying
无边无际	wu bian wu ji
既往不咎	ji wang bu jiu
既得利益	ji de li yi
既成事实	ji cheng shi shi
日上三竿	ri shang san gan
日久天长	ri jiu tian chang
日以继夜	ri yi ji ye
日出而作	ri chu er zuo
日复一日	ri fu yi ri
日夜兼程	ri ye jian cheng
日新月异	ri xin yue yi
日日夜夜	ri ri ye ye
日暮途穷	ri mu tu qiong
日月如梭	ri yue ru suo
日月无光	ri yue wu guang
日理万机	ri li wan ji
日积月累	ri ji yue lei
日臻完善	ri zhen wan shan
日落西山	ri luo xi shan
日薄西山	ri bo xi shan
日行千里	ri xing qian li
日进斗金	ri jin dou jin
旧事重提	jiu shi zhong ti
旧地重游	jiu di chong you
旧病复发	jiu bing fu fa
旧话重提	jiu hua chong ti
旧调重弹	jiu diao chong tan
早出晚归	zao chu wan gui
早出暮归	zao chu mu gui
旭日东升	xu ri dong sheng
旱涝保收	han lao bao shou
时不再来	shi bu zai lai
时不我待	shi bu wo dai
时断时续	shi duan shi xu
时时刻刻	shi shi ke ke
时来运转	shi lai yun zhuan
时过境迁	shi guo jing qian
时运不济	shi yun bu ji
时隐时现	shi yin shi xian
旷日持久	kuang ri chi jiu
昂首挺胸	ang shou ting xiong
昂首阔步	ang shou kuo bu
明争暗斗	ming zheng an dou
明升暗降	ming sheng an jiang
明哲保身	ming zhe bao shen
明如指掌	ming ru zhi zhang
明媒正娶	ming mei zheng qu
明察暗访	ming cha an fang
明察秋毫	ming cha qiu hao
明日黄花	ming ri huang hua
明明白白	ming ming bai bai
明来暗往	ming lai an wang
明枪暗箭	ming qiang an jian
明查暗访	ming cha an fang
明珠暗投	ming zhu an tou
明目张胆	ming mu zhang dan
明眸皓齿	ming mou hao chi
明知故犯	ming zhi gu fan
明知故问	ming zhi gu wen
明码实价	ming ma shi jia
明辨是非	ming bian shi fei
昏天暗地	hun tian an di
昏天黑地	hun tian hei di
昏头昏脑	hun tou hun nao
昏头转向	hun tou zhuan xiang
昏庸无道	hun yong wu dao
昏昏欲睡	hun hun yu shui
昏昏沉沉	hun hun chen chen
昏迷不醒	hun mi bu xing
易如反掌	yi ru fan zhang
易如翻掌	yi ru fan zhang
昙花一现	tan hua yi xian
星星之火	xing xing zhi huo
星星点点	xing xing dian dian
星火燎原	xing huo liao yuan
星罗棋布	xing luo qi bu
春光明媚	chun guang ming mei
春华秋实	chun hua qiu shi
春去冬来	chun qu dong lai
春去秋来	chun qu qiu lai
春回大地	chun hui da di
春宵一刻	chun xiao yi ke
春寒料峭	chun han liao qiao
春意盎然	chun yi ang ran
春暖花开	chun nuan hua kai
春色满园	chun se man yuan
春花秋月	chun hua qiu yue
春风化雨	chun feng hua yu
春风得意	chun feng de yi
春风满面	chun feng man mian
昭然若揭	zhao ran ruo jie
是是非非	shi shi fei fei
是非不分	shi fei bu fen
是非之地	shi fei zhi di
是非分明	shi fei fen ming
是非曲直	shi fei qu zhi
是非颠倒	shi fei dian dao
昼夜兼程	zhou ye jian cheng
昼思夜想	zhou si ye xiang
显而易见	xian er yi jian
显赫一时	xian he yi shi
晕头转向	yun tou zhuan xiang
晚节不保	wan jie bu bao
晨钟暮鼓	chen zhong mu gu
普天之下	pu tian zhi xia
普天同庆	pu tian tong qing
普度众生	pu du zhong sheng
普普通通	pu pu tong tong
普渡众生	pu du zhong sheng
晴天霹雳	qing tian pi li
晴空万里	qing kong wan li
智勇兼备	zhi yong jian bei
智勇双全	zhi yong shuang quan
暑往寒来	shu wang han lai
暗中作梗	an zhong zuo geng
暗中摸索	an zhong mo suo
暗度陈仓	an du chen cang
暗无天日	an wu tian ri
暗淡无光	an dan wu guang
暗渡陈仓	an du chen cang
暗箭伤人	an jian shang ren
暗箭难防	an jian nan fang
暗藏杀机	an cang sha ji
暗送秋波	an song qiu bo
暧昧不明	ai mei bu ming
暮气沉沉	mu qi chen chen
暮鼓晨钟	mu gu chen zhong
暴殄天物	bao tian tian wu
暴跳如雷	bao tiao ru lei
暴露无遗	bao lu wu yi
暴风骤雨	bao feng zhou yu
暴饮暴食	bao yin bao shi
曲不离口	qu bu li kou
曲径通幽	qu jing tong you
曲意迎合	qu yi ying he
曲意逢迎	qu yi feng ying
曲曲折折	qu qu zhe zhe
曲高和寡	qu gao he gua
更新换代	geng xin huan dai
曾几何时	ceng ji he shi
曾经沧海	ceng jing cang hai
替天行道	ti tian xing dao
月下老人	yue xia lao ren
月明星稀	yue ming xing xi
月朗星稀	yue lang xing xi
月黑风高	yue hei feng gao
有伤风化	you shang feng hua
有借无还	you jie wu huan
有凭有据	you ping you ju
有则改之	you ze gai zhi
有利可图	you li ke tu
有利无弊	you li wu bi
有利有弊	you li you bi
有勇无谋	you yong wu mou
有勇有谋	you yong you mou
有去无回	you qu wu hui
有口无心	you kou wu xin
有口皆碑	you kou jie bei
有口莫辩	you kou mo bian
有口难言	you kou nan yan
有口难辩	you kou nan bian
有名无实	you ming wu shi
有名有姓	you ming you xing
有增无减	you zeng wu jian
有声有色	you sheng you se
有备无患	you bei wu huan
有头无尾	you tou wu wei
有头有尾	you tou yuo wei
有头有脸	you tou you lian
有始无终	you shi wu zhong
有始有终	you shi you zhong
有害无益	you hai wu yi
有张有弛	you zhang you chi
有心无力	you xin wu li
有志之士	you zhi zhi shi
有志竟成	you zhi jing cheng
有恃不恐	you shi bu kong
有恃无恐	you shi wu kong
有情有义	you qing you yi
有惊无险	you jing wu xian
有意无意	you yi wu yi
有所不为	you suo bu wei
有所作为	you suo zuo wei
有损无益	you sun wu yi
有教无类	you jiao wu lei
有朝一日	you zhao yi ri
有机可乘	you ji ke cheng
有权有势	you quan you shi
有条不紊	you tiao bu wen
有条有理	you tiao you li
有来无回	you lai wu hui
有来有往	you lai you wang
有板有眼	you ban you yan
有根有据	you gen you ju
有案可查	you an ke cha
有棱有角	you leng you jiao
有模有样	you mo you yang
有气无力	you qi wu li
有气没力	you qi mei li
有求必应	you qiu bi ying
有滋有味	you zi you wei
有生之年	you sheng zhi nian
有生以来	you sheng yi lai
有生力量	you sheng li liang
有的放矢	you di fang shi
有目共睹	you mu gong du
有目共赏	you mu gong shang
有眼无珠	you yan wu zhu
有福同享	you fu tong xiang
有章可循	you zhang ke xun
有约在先	you yue zai xian
有胆有识	you dan you shi
有色眼镜	you se yan jing
有血有肉	you xue you rou
有言在先	you yan zai xian
有识之士	you shi zhi shi
有说有笑	you shuo you xiao
有负众望	you fu zhong wang
有进无退	you jin wu tui
有钱有势	you qian you shi
有问必答	you wen bi da
朋比为奸	peng bi wei jian
服服帖帖	fu fu tie tie
朗朗上口	lang lang shang kou
望其项背	wang qi xiang bei
望子成龙	wang zi cheng long
望尘不及	wang chen bu ji
望尘莫及	wang chen mo ji
望文生义	wang wen sheng yi
望梅止渴	wang mei zhi ke
望洋兴叹	wang yang xing tan
望眼欲穿	wang yan yu chuan
望穿秋水	wang chuan qiu shui
望而却步	wang er que bu
望而生畏	wang er sheng wei
望风而逃	wang feng er tao
朝三暮四	zhao san mu si
朝不保夕	zhao bu bao xi
朝令夕改	zhao ling xi gai
朝令暮改	zhao ling mu gai
朝发夕至	zhao fa xi zhi
朝夕相处	zhao xi xiang chu
朝思暮想	zhao si mu xiang
朝朝暮暮	zhao zhao mu mu
朝气勃勃	zhao qi bo bo
朝气蓬勃	zhao qi peng bo
朝秦暮楚	zhao qin mu chu
朦朦胧胧	meng meng long long
木已成舟	mu yi cheng zhou
未卜先知	wei bu xian zhi
未可厚非	wei ke hou fei
未尝不可	wei chang bu ke
未老先衰	wei lao xian shuai
未雨绸缪	wei yu chou mou
本性难移	ben xing nan yi
本末倒置	ben mo dao zhi
本本分分	ben ben fen fen
本来面目	ben lai mian mu
朴实无华	pu shi wu hua
朴素无华	pu su wu hua
机不可失	ji bu ke shi
机会主义	ji hui zhu yi
机关算尽	ji guan suan jin
朽木难雕	xiu mu nan diao
杀一儆百	sha yi jing bai
杀人如麻	sha ren ru ma
杀人放火	sha ren fang huo
杀人灭口	sha ren mie kou
杀回马枪	sha hui ma qiang
杀气腾腾	sha qi teng teng
杀身之祸	sha shen zhi huo
杀身成仁	sha shen cheng ren
杀鸡儆猴	sha ji jing hou
杀鸡取卵	sha ji qu luan
杀鸡吓猴	sha ji xia hou
杂七杂八	za qi za ba
杂乱无序	za luan wu xu
杂乱无章	za luan wu zhang
权宜之计	quan yi zhi ji
权衡利弊	quan heng li bi
权衡得失	quan heng de shi
权衡轻重	quan heng qing zhong
杜绝后患	du jue hou huan
杞人忧天	qi ren you tian
束之高阁	shu zhi gao ge
束手就擒	shu shou jiu qin
束手待毙	shu shou dai bi
束手无策	shu shou wu ce
束手束脚	shu shou shu jiao
条分缕析	tiao fen lu xi
条条框框	tiao tiao kuang kuang
来之不易	lai zhi bu yi
来势汹汹	lai shi xiong xiong
来历不明	lai li bu ming
来去匆匆	lai qu cong cong
来去无踪	lai qu wu zong
来日方长	lai ri fang chang
来来去去	lai lai qu qu
来来往往	lai lai wang wang
来者不善	lai zhe bu shan
来者不拒	lai zhe bu ju
来路不明	lai lu bu ming
来龙去脉	lai long qu mai
杯弓蛇影	bei gong she ying
杯水车薪	bei shui che xin
杯盘狼藉	bei pan lang ji
杳无人烟	yao wu ren yan
杳无消息	yao wu xiao xi
杳无踪影	yao wu zong ying
杳无踪迹	yao wu zong ji
杳无音信	yao wu yin xin
杳无音讯	yao wu yin xun
松松垮垮	song song kua kua
板上钉钉	ban shang ding ding
极乐世界	ji le shi jie
极目远望	ji mu yuan wang
极目远眺	ji mu yuan tiao
枉法徇私	wang fa xun si
枉费口舌	wang fei kou she
枉费工夫	wang fei gong fu
枉费心思	wang fei xin si
枉费心机	wang fei xin ji
枕戈待旦	zhen ge dai dan
林林总总	lin lin zong zong
果不其然	guo bu qi ran
果然如此	guo ran ru ci
枝繁叶茂	zhi fan ye mao
枪林弹雨	qiang lin dan yu
枯木逢春	ku mu feng chun
枯枝败叶	ku zhi bai ye
枯燥乏味	ku zao fa wei
枯燥无味	ku zao wu wei
枯瘦如柴	ku shou ru chai
柔情似水	rou qing si shui
柔情蜜意	rou qing mi yi
柔肠寸断	rou chang cun duan
柔能克刚	rou neng ke gang
柳暗花明	liu an hua ming
柳绿桃红	liu lu tao hong
柳绿花红	liu lu hua hong
柴米油盐	chai mi you yan
标奇立异	biao qi li yi
标新立异	biao xin li yi
标本兼治	biao ben jian zhi
栋梁之才	dong liang zhi cai
栋梁之材	dong liang zhi cai
树大招风	shu da zhao feng
树大根深	shu da gen shen
树碑立传	shu bei li zhuan
栩栩如生	xu xu ru sheng
样样俱全	yang yang ju quan
根深叶茂	gen shen ye mao
根深柢固	gen shen di gu
根深蒂固	gen shen di gu
格杀勿论	ge sha wu lun
格格不入	ge ge bu ru
桀骜不驯	jie ao bu xun
桃红柳绿	tao hong liu lu
梁上君子	liang shang jun zi
梦寐以求	meng mei yi qiu
梨花带雨	li hu ai yu
梳妆打扮	shu zhuang da ban
棋逢对手	qi feng dui shou
棋逢敌手	qi feng di shou
棋高一着	qi gao yi zhao
棒打鸳鸯	bang da yuan yang
楚楚动人	chu chu dong ren
楚楚可怜	chu chu ke lian
榆木疙瘩	yu mu ge da
榆木脑袋	yu mu nao dai
榜上无名	bang shang wu ming
模棱两可	mo leng liang ke
模模糊糊	mo mo hu hu
横七竖八	heng qi shu ba
横冲直撞	heng chong zhi zhuang
横加干涉	heng jia gan she
横加指责	heng jia zhi ze
横征暴敛	heng zheng bao lian
横扫千军	heng sao qian jun
横生枝节	heng sheng zhi jie
横眉怒目	heng mei nu mu
横眉瞪眼	heng mei deng yan
横眉竖目	heng mei shu mu
横眉竖眼	heng mei shu yan
横蛮无理	heng man wu li
横行天下	heng xing tian xia
横行无忌	heng xing wu ji
横行霸道	heng xing ba dao
欢呼雀跃	huan hu que yue
欢呼雷动	huan hu lei dong
欢呼鼓舞	huan hu gu wu
欢喜冤家	huan xi yuan jia
欢喜若狂	huan xi ruo kuang
欢声笑语	huan sheng xiao yu
欢声雷动	huan sheng lei dong
欢天喜地	huan tian xi di
欢欢喜喜	huan huan xi xi
欢欣若狂	huan xin ruo kuang
欢欣鼓舞	huan xin gu wu
欢聚一堂	huan ju yi tang
欢蹦乱跳	huan beng luan tiao
欣喜若狂	xin xi ruo kuang
欣欣向荣	xin xin xiang rong
欲加之罪	yu jia zhi zui
欲壑难填	yu he nan tian
欲扬先抑	yu yang xian yi
欲擒故纵	yu qin gu zong
欲盖弥彰	yu gai mi zhang
欲罢不能	yu ba bu neng
欲言又止	yu yan you zhi
欲速不达	yu su bu da
欺上压下	qi shang ya xia
欺上瞒下	qi shang man xia
欺世盗名	qi shi dao ming
欺世钓誉	qi shi diao yu
欺人太甚	qi ren tai shen
欺善怕恶	qi shan pa e
欺行霸市	qi hang ba shi
欺贫爱富	qi pin ai fu
欺软怕硬	qi ruan pa ying
歇斯底里	xie si di li
歌功颂德	ge gong song de
歌舞升平	ge wu sheng ping
正中下怀	zheng zhong xia huai
正义凛然	zheng yi lin ran
正人君子	zheng ren jun zi
正儿八经	zheng er ba jing
正大光明	zheng da guang ming
正本清源	zheng ben qing yuan
正气凛然	zheng qi lin ran
正直无私	zheng zhi wu si
正襟危坐	zheng jin wei zuo
正颜厉色	zheng yan li se
此伏彼起	ci fu bi qi
此起彼伏	ci qi bi fu
此起彼落	ci qi bi luo
步人后尘	bu ren hou chen
步履维艰	bu lu wei jian
步履艰难	bu lu jian nan
步履蹒跚	bu lu pan shan
步态蹒跚	bu tai pan shan
步步为营	bu bu wei ying
步步深入	bu bu shen ru
步步登高	bu bu deng gao
步步紧逼	bu bu jin bi
步步进逼	bu bu jin bi
步步高升	bu bu gao sheng
步调一致	bu diao yi zhi
武断专横	wu duan zhuan heng
武艺超群	wu yi chao qun
歪七扭八	wai qi niu ba
歪打正着	wai da zheng zhao
歪歪扭扭	wai wai niu niu
歪门邪道	wai men xie dao
歪风邪气	wai feng xie qi
死不悔改	si bu hui gai
死不改悔	si bu gai hui
死不瞑目	si bu ming mu
死于非命	si yu fei ming
死去活来	si qu huo lai
死得其所	si de qi suo
死心塌地	si xin ta di
死心眼儿	si xin yan er
死搬硬套	si ban ying tao
死无对证	si wu dui zheng
死有余辜	si you yu gu
死气沉沉	si qi chen chen
死灰复燃	si hui fu ran
死皮赖脸	si pi lai lian
死而后已	si er hou yi
死而复生	si er fu sheng
死而无憾	si er wu han
死要面子	si yao mian zi
死记硬背	si ji ying bei
死路一条	si lu yi tiao
死里求生	si li qiu sheng
死里逃生	si li tao sheng
殃及池鱼	yang ji chi yu
殊路同归	shu lu tong gui
殊途同归	shu tu tong gui
残兵败将	can bing bai jiang
残垣断壁	can yuan duan bi
残暴不仁	can bao bu ren
残汤剩饭	can tang sheng fan
残缺不全	can que bu quan
残羹冷炙	can geng leng zhi
残羹冷饭	can geng leng fan
残羹剩饭	can geng sheng fan
残茶剩饭	can cha sheng fan
残酷无情	can ku wu qing
殚精竭虑	dan jing jie lu
毁于一旦	hui yu yi dan
毁誉参半	hui yu can ban
毅然决然	yi ran jue ran
毋庸置疑	wu yong zhi yi
母慈子孝	mu ci zi xiao
每况愈下	mei kuang yu xia
每时每刻	mei shi mei ke
比下有余	bi xia you yu
比手划脚	bi shou hua jiao
比手画脚	bi shou hua jiao
比比皆是	bi bi jie shi
比翼双飞	bi yi shuang fei
比翼齐飞	bi yi qi fei
毕恭毕敬	bi gong bi jing
毛手毛脚	mao shou mao jiao
毛毛细雨	mao mao xi yu
毛遂自荐	mao sui zi jian
毛骨悚然	mao gu song ran
毫不介意	hao bu jie yi
毫不关心	hao bu guan xin
毫不动摇	hao bu dong yao
毫不含糊	hao bu han hu
毫不在乎	hao bu zai hu
毫不在意	hao bu zai yi
毫不犹豫	hao bu you yu
毫不留情	hao bu liu qing
毫不相干	hao bu xiang gan
毫不讳言	hao bu hui yan
毫不迟疑	hao bu chi yi
毫无二致	hao wu er zhi
毫无例外	hao wu li wai
毫无疑义	hao wu yi yi
毫无疑问	hao wu yi wen
毫无逊色	hao wu xun se
毫无顾忌	hao wu gu ji
毫无顾虑	hao wu gu lu
民不聊生	min bu liao sheng
民为邦本	min wei bang ben
民富国强	min fu guo qiang
民怨沸腾	min yuan fei teng
民脂民膏	min zhi min gao
气势汹汹	qi shi xiong xiong
气势磅礴	qi shi pang bo
气吞山河	qi tun shan he
气味相投	qi wei xiang tou
气喘吁吁	qi chuan xu xu
气壮山河	qi zhuang shan he
气宇不凡	qi yu bu fan
气宇轩昂	qi yu xuan ang
气度不凡	qi du bu fan
气急败坏	qi ji bai huai
气息奄奄	qi xi yan yan
气数已尽	qi shu yi jin
气焰嚣张	qi yan xiao zhang
气象一新	qi xiang yi xin
气象万千	qi xiang wan qian
气贯长虹	qi guan chang hong
水中捞月	shui zhong lao yue
水乳交融	shui ru jiao rong
水到渠成	shui dao qu cheng
水土不服	shui tu bu fu
水天一色	shui tian yi se
水性杨花	shui xing yang hua
水来土掩	shui lai tu yan
水泄不通	shui xie bu tong
水洩不通	shui xie bu tong
水涨船高	shui zhang chuan gao
水深火热	shui shen huo re
水满则溢	shui man ze yi
水滴石穿	shui di shi chuan
水漫金山	shui man jin shan
水火不容	shui huo bu rong
水火无情	shui huo wu qing
水落石出	shui luo shi chu
永不磨灭	yong bu mo mie
永世不忘	yong shi bu wang
永世长存	yong shi chang cun
永垂不朽	yong chui bu xiu
永垂青史	yong chui qing shi
永无宁日	yong wu ning ri
永无止境	yong wu zhi jing
求之不得	qiu zhi bu de
求全责备	qiu quan ze bei
求同存异	qiu tong cun yi
求新立异	qiu xin li yi
求知若渴	qiu zhi ruo ke
求神拜佛	qiu shen bai fo
求贤如渴	qiu xian ru ke
求贤若渴	qiu xian ruo ke
汗如雨下	han ru yu xia
汗流浃背	han liu jia bei
汗牛充栋	han niu chong dong
汗马功劳	han ma gong lao
江山如画	jiang shan ru hua
江河日下	jiang he ri xia
江洋大盗	jiang yang da dao
江湖义气	jiang hu yi qi
江湖骗子	jiang hu pian zi
江郎才尽	jiang lang cai jin
污七八糟	wu qi ba zao
污言秽语	wu yan hui yu
汪洋大海	wang yang da hai
汹涌澎湃	xiong yong peng pai
沁人心脾	qin ren xin pi
沁人肺腑	qin ren fei fu
沆瀣一气	hang xie yi qi
沉不住气	chen bu zhu qi
沉思熟虑	chen si shu lu
沉鱼落雁	chen yu luo yan
沉默不语	chen mo bu yu
沉默寡言	chen mo gua yan
沙里淘金	sha li tao jin
没事找事	mei shi zhao shi
没大没小	mei da mei xiao
没头没脑	mei tou mei nao
没头苍蝇	mei tou cang ying
没完没了	mei wan mei liao
没心没肺	mei xin mei fei
没日没夜	mei ri mei ye
没皮没脸	mei pi mei lian
没精打采	mei jing da cai
没脸没皮	mei lian mei pi
没轻没重	mei qing mei zhong
没齿不忘	mo chi bu wang
没齿难忘	mo chi nan wang
沧海一粟	cang hai yi su
沧海桑田	cang hai sang tian
沸沸扬扬	fei fei yang yang
油嘴滑舌	you zui hua she
油头粉面	you tou fen mian
油尽灯枯	you jin deng ku
油然而生	you ran er sheng
油盐酱醋	you yan jiang cu
油腔滑调	you qiang hua diao
治国安民	zhi guo an min
治病救人	zhi bing jiu ren
沽名钓誉	gu ming diao yu
沾亲带故	zhan qin dai gu
沾沾自喜	zhan zhan zi xi
沾花惹草	zhan hua re cao
泄漏天机	xie lou tian ji
泄露天机	xie lou tian ji
法不容情	fa ru rong qing
法不责众	fa bu ze zhong
泛泛之交	fan fan zhi jiao
泛泛而谈	fan fan er tan
泛滥成灾	fan lan cheng zai
波光粼粼	bo guang lin lin
波涛汹涌	bo tao xiong yong
波澜不惊	bo lan bu jing
波澜壮阔	bo lan zhuang kuo
泣不成声	qi bu cheng sheng
泥沙俱下	ni sha ju xia
泪如泉涌	lei ru quan yong
泪如雨下	lei ru yu xia
泪流满面	lei liu man mian
泰山北斗	tai shan bei dou
泰山压顶	tai shan ya ding
泰然处之	tai ran chu zhi
泰然自得	tai ran zi de
泰然自若	tai ran zi ruo
泼妇骂街	po fu ma jie
泽被后世	ze bei hou shi
泾渭不分	jing wei bu fen
泾渭分明	jing wei fen ming
洁身自好	jie shen zi hao
洁身自爱	jie shen zi ai
洋为中用	yang wei zhong yong
洋洋得意	yang yang de yi
洋洋洒洒	yang yang sa sa
洋洋自得	yang yang zi de
洋相百出	yang xiang bai chu
洗劫一空	xi jie yi kong
洗心革面	xi xin ge mian
洗手不干	xi shou bu gan
洗耳恭听	xi er gong ting
洛阳纸贵	luo yang zhi gui
洞察一切	dong cha yi qie
洞察秋毫	dong cha qiu hao
洞房花烛	dong fang hua zhu
洞若观火	dong ruo guan huo
津津乐道	jin jin le dao
津津有味	jin jin you wei
洪水猛兽	hong shui meng shou
活灵活现	huo ling huo xian
活蹦乱跳	huo beng luan tiao
活龙活现	huo long huo xian
流光溢彩	liu guang yi cai
流年不利	liu nian bu li
流离失所	liu li shi suo
流芳千古	liu fang qian gu
流芳后世	liu fang hou shi
流芳百世	liu fang bai shi
流落他乡	liu luo ta xiang
流落异乡	liu luo yi xiang
流血成河	liu xue cheng he
流言惑众	liu yan huo zhong
流言蜚语	liu yan fei yu
流言飞语	liu yan fei yu
流连忘返	liu lian wang fan
流里流气	liu li liu qi
浅尝辄止	qian chang zhe zhi
浅显易懂	qian xian yi dong
济世救人	ji shi jiu ren
济济一堂	ji ji yi tang
浑水摸鱼	hun shui mo yu
浑浑噩噩	hun hun e e
浑然一体	hun ran yi ti
浑然天成	hun ran tian cheng
浑身是胆	hun shen shi dan
浑身解数	hun shen xie shu
浓墨重彩	nong mo zhong cai
浓妆淡抹	nong zhuang dan mo
浓妆艳抹	nong zhuang yan mo
浓眉大眼	nong mei da yan
浩如烟海	hao ru yan hai
浩气长存	hao qi chang cun
浩浩荡荡	hao hao dang dang
浩然正气	hao ran zheng qi
浪子回头	lang zi hui tou
浪费笔墨	lang fei bi mo
浪迹天涯	lang ji tian ya
浪迹江湖	lang ji jiang hu
浮光掠影	fu guang lue ying
浮出水面	fu chu shui mian
浮想联翩	fu xiang lian pian
浴血奋战	yu xue fen zhan
海市蜃楼	hai shi shen lou
海底捞月	hai di lao yue
海底捞针	hai di lao zhen
海枯石烂	hai ku shi lan
海纳百川	hai na bai chuan
海角天涯	hai jiao tian ya
海誓山盟	hai shi shan meng
海阔天空	hai kuo tian kong
涂脂抹粉	tu zhi mo fen
消声匿迹	xiao sheng ni ji
消息灵通	xiao xi ling tong
消极怠工	xiao ji dai gong
消释前嫌	xiao shi qian xian
消除异己	xiao chu yi ji
涉世未深	she shi wei shen
涸泽而渔	he ze er yu
淋漓尽致	lin li jin zhi
淡妆浓抹	dan zhuang nong mo
淡泊明志	dan bo ming zhi
淡然处之	dan ran chu zhi
淡而无味	dan er wu wei
深不可测	shen bu ke ce
深仇大恨	shen chou da hen
深信不疑	shen xin bu yi
深入人心	shen ru ren xin
深入浅出	shen ru qian chu
深入细致	shen ru xi zhi
深入骨髓	shen ru gu sui
深宅大院	shen zhai da yuan
深居简出	shen ju jian chu
深山老林	shen shan lao lin
深得人心	shen de ren xin
深得民心	shen de min xin
深思熟虑	shen si shu lu
深思远虑	shen si yuan lu
深恶痛恨	shen wu tong hen
深恶痛疾	shen wu tong ji
深恶痛绝	shen wu tong jue
深情厚意	shen qing hou yi
深情厚谊	shen qing hou yi
深明大义	shen ming da yi
深更半夜	shen geng ban ye
深藏简出	shen cang jian chu
深谋远虑	shen mou yuan lu
深谋远计	shen mou yuan ji
混世魔王	hun shi mo wang
混为一谈	hun wei yi tan
混作一谈	hun zuo yi tan
混水摸鱼	hun shui mo yu
混淆是非	hun xiao shi fei
混淆视听	hun xiao shi ting
混淆黑白	hun xiao hei bai
添枝加叶	tian zhi jia ye
添油加醋	tian you jia cu
添砖加瓦	tian zhuan jie wa
清廉正直	qing lian zheng zhi
清心寡欲	qing xin gua yu
清正廉明	qing zheng lian ming
清正廉洁	qing zheng lian jie
清水衙门	qing shui ya men
清汤寡水	qing tang gua shui
清清楚楚	qing qing chu chu
清清白白	qing qing bai bai
清规戒律	qing gui jie lu
清闲自在	qing xian zi zai
清风明月	qing feng ming yue
渐入佳境	jian ru jia jing
渔人得利	yu ren de li
渔翁得利	yu weng de li
温情脉脉	wen qing mo mo
温故知新	wen gu zhi xin
温文儒雅	wen wen ru ya
温文尔雅	wen wen er ya
温柔体贴	wen rou ti tie
温柔敦厚	wen rou dun hou
游刃有余	you ren you yu
游山玩水	you shan wan shui
游手好闲	you shou hao xian
游移不定	you yi bu ding
渺无人烟	miao wu ren yan
渺无音信	miao wu yin xin
渺无音讯	miao wu yin xun
湖光山色	hu guang shan se
溃不成军	kui bu cheng jun
源源不断	yuan yuan bu duan
源源不绝	yuan yuan bu jue
源源而来	yuan yuan er lai
源远流长	yuan yuan liu chang
溜之大吉	liu zhi da ji
溜须拍马	liu xu pai ma
溢于言表	yi yu yan biao
溢美之辞	yi mei zhi ci
溯流而上	su liu er shang
滂沱大雨	pang tuo da yu
滔天大罪	tao tian da zui
滔天罪行	tao tian zui xing
滔滔不绝	tao tao bu jue
滚滚而来	gun gun er lai
滚瓜烂熟	gun gua lan shu
满不在乎	man bu zai hu
满园春色	man yuan chun se
满城风雨	man cheng feng yu
满山遍野	man shan bian ye
满心欢喜	man xin huan xi
满怀信心	man huai xin xin
满打满算	man da man suan
满满当当	man man dang dang
满盘皆输	man pan jie shu
满目凄凉	man mu qi liang
满目疮痍	man mu chuang yi
满脸春风	man lian chun feng
满腔怒火	man qiang nu huo
满腔悲愤	man qiang bei fen
满腔热忱	man qiang re chen
满腔热血	man qiang re xue
满腹牢骚	man fu lao sao
满腹狐疑	man fu hu yi
满腹经纶	man fu jing lun
满载而归	man zai er gui
满面春风	man mian chun feng
满面红光	man mian hong guang
滥用职权	lan yong zhi quan
滥竽充数	lan yu chong shu
滴水不漏	di shui bu lou
滴水成冰	di shui cheng bing
滴水穿石	di shui chuan shi
滴酒不沾	di jiu bu zhan
漂泊无定	piao bo wu ding
漂浮不定	piao fu bu ding
漆黑一团	qi hei yi tuan
漏洞百出	lou dong bai chu
漏网之鱼	lou wang zhi yu
漠不关心	mo bu guan xin
漠然置之	mo ran zhi zhi
漫不经心	man bu jing xin
漫天开价	man tian kai jia
漫天要价	man tian yao jia
漫天遍野	man shan bian ye
漫天风雪	man tian feng xue
漫山遍野	man shan bian ye
漫无边际	man wu bian ji
漫漫长夜	man man chang ye
潇潇洒洒	xiao xiao sa sa
潜移默化	qian yi mo hua
潸然泪下	shan ran lei xia
激昂慷慨	ji ang kang kai
激起公愤	ji qi gong fen
火上加油	huo shang jia you
火上浇油	huo shang jiao you
火上添油	huo shang tian you
火中取栗	huo zhong qu li
火光冲天	huo guang chong tian
火冒三丈	huo mao san zhang
火急火燎	huo ji huo liao
火树银花	huo shu yin hua
火烧火燎	huo shao huo liao
火烧眉毛	huo shao mei mao
火眼金睛	huo yan jin jing
灭绝人性	mie jue ren xing
灭顶之灾	mie ding zhi zai
灯火辉煌	deng huo hui huang
灯红酒绿	deng hong jiu lu
灯蛾扑火	de e pu huo
灰头土脸	hui tou tu lian
灰心丧气	hui xin sang qi
灰飞烟灭	hui fei yan mie
灵丹妙药	ling dan miao yao
灵机一动	ling ji yi dong
灾难深重	zai nan shen zhong
灿烂夺目	can lan duo mu
灿烂辉煌	can lan hui huang
炉火纯青	lu huo chun qing
炎黄子孙	yan huang zi sun
炙手可热	zhi shou ke re
炮火连天	pao huo lian tian
炯炯有神	jiong jiong you shen
点头之交	dian tou zhi jiao
点头哈腰	dian tou ha yao
点头称是	dian tou cheng shi
点点滴滴	dian dian di di
点睛之笔	dian jing zhi bi
点石成金	dian shi cheng jin
烂漫天真	lan man tian zhen
烂醉如泥	lan zui ru ni
烘云托月	hong yun tuo yue
烟波浩渺	yan bo hao miao
烟消云散	yan xiao yun san
烟消雾散	yan xiao wu san
烟熏火燎	yan xun huo liao
热情奔放	re qing ben fang
热情洋溢	re qing yang yi
热气腾腾	re qi teng teng
热泪盈眶	re lei ying kuang
热火朝天	re huo chao tian
热热闹闹	re re nao nao
热血沸腾	re xue fei teng
烽火连天	feng huo lian tian
焕然一新	huan ran yi xin
焚书坑儒	fen shu keng ru
焦头烂额	jiao tou lan e
焦躁不安	jiao zao bu an
煞有介事	sha you jie shi
煞费苦心	sha fei ku xin
照单全收	zhao dan quan shou
照本宣科	zhao ben xuan ke
照猫画虎	zhao mao hua hu
照章办事	zhao zhang ban shi
煮豆燃萁	zhu dou ran qi
煽风点火	shan feng dian huo
熊熊烈火	xiong xiong lie huo
熙来攘往	xi lai rang wang
熙熙攘攘	xi xi rang rang
熟能生巧	shu neng sheng qiao
熟视无睹	shu shi wu du
熟门熟路	shu men shu lu
熠熠生辉	yi yi sheng hui
燃眉之急	ran mei zhi ji
燎原之势	liao yuan zhi shi
爆跳如雷	bao tiao ru lei
爬山涉水	pa shan she shui
爱不释手	ai bu shi shou
爱屋及乌	ai wu ji wu
爱惜羽毛	ai xi yu mao
爱憎分明	ai zeng fen ming
爱才如命	ai cai ru ming
爱才若渴	ai cai ruo ke
爱民如子	ai min ru zi
爱理不理	ai li bu li
爱答不理	ai da bu li
爱莫能助	ai mo neng zhu
爱财如命	ai cai ru ming
爱钱如命	ai qian ru ming
父债子还	fu zhai zi huan
父慈子孝	fu ci zi xiao
爽心悦目	shuang xin yue mu
片甲不留	pian jia bu liu
片言只语	pian yan zhi yu
牙牙学语	ya ya xue yu
牛刀小试	niu dao xiao shi
牛毛细雨	niu mao xi yu
牛皮大王	niu pi da wang
牛郎织女	niu lang zhi nu
牛高马大	niu gao ma da
牛鬼蛇神	niu gui she shen
牢不可破	lao bu ke po
物以类聚	wu yi lei ju
物以群分	wu yi qun fen
物尽其用	wu jin qi yong
物归原主	wu gui yuan zhu
物是人非	wu shi ren fei
物极必反	wu ji bi fan
物欲横流	wu yu heng liu
物竞天择	wu jin tian ze
物美价廉	jia lian wu mei
牵强附会	qian qiang fu hui
牵肠挂肚	qian chang gua du
特立独行	te li du xing
犬牙交错	quan ya jiao cuo
犬马之劳	quan ma zhi lao
犯上作乱	fan shang zuo luan
犹豫不决	you yu bu jue
犹豫不定	you yu bu ding
狂妄自大	kuang wang zi da
狂涛骇浪	kuang tao hai lang
狂轰滥炸	kuang hong lan zha
狂风大作	kuang feng da zuo
狂风巨浪	kuang feng ju lang
狂风怒号	kuang feng nu hao
狂风怒吼	kuang feng nu hou
狂风恶浪	kuang feng e lang
狂风暴雨	kuang feng bao yu
狂风骤雨	kuang feng zhou yu
狐假虎威	hu jia hu wei
狐朋狗党	hu peng gou dang
狐朋狗友	hu peng gou you
狐狸尾巴	hu li wei ba
狐群狗党	hu qun gou dang
狗仗人势	gou zhang ren shi
狗头军师	gou tou jun shi
狗尾续貂	gou wei xu diao
狗屁不通	gou pi bu tong
狗急跳墙	gou ji tiao qiang
狗皮膏药	gou pi gao yao
狗眼看人	gou yan kan ren
狗胆包天	gou dan bao tian
狗血喷头	gou xue pen tou
狡兔三窟	jiao tu san ku
独一无二	du yi wu er
独具一格	du ju yi ge
独具匠心	du ju jiang xin
独具慧眼	du ju hui yan
独出心裁	du chu xin cai
独到之处	du dao zhi chu
独力难支	du li nan zhi
独占鳌头	du zhan ao tou
独善其身	du shan qi shen
独守空房	du shou kong fang
独当一面	du dang yi mian
独往独来	du wang du lai
独揽大权	du lan da quan
独断专行	du duan zhuan xing
独断独行	du duan du xing
独木难支	du mu nan zhi
独来独往	du lai du wang
独树一帜	du shu yi zhi
独步天下	du bu tian xia
独立王国	du li wang guo
独立自主	du li zi zhu
独辟蹊径	du pi xi jing
独霸一方	du ba yi fang
狭路相逢	xia lu xiang feng
狼吞虎咽	lang tun hu yan
狼多肉少	lang duo rou shao
狼子野心	lang zi ye xin
狼心狗肺	lang xin gou fei
狼烟四起	lang yan si qi
狼狈不堪	lang bei bu kan
狼狈为奸	lang bei wei jian
狼狈逃窜	lang bei tao cuan
狼窝虎穴	lang wo hu xue
猛虎下山	meng hu xia shan
猛虎扑食	meng hu pu shi
猝不及防	cu bu ji fang
猪朋狗友	zhu peng gou you
猪狗不如	zhu gou bu ru
猫哭耗子	mao ku hao zi
献计献策	xian ji xian ce
猴年马月	hou nian ma yue
獐头鼠目	zhang tou shu mu
玉树临风	yu shu lin feng
玉洁冰清	yu jie bing qing
玉石俱焚	yu shi ju fen
玉碎瓦全	yu sui wa quan
玩世不恭	wan shi bu gong
玩忽职守	wan hu zhi shou
玩火自焚	wan huo zi fen
玩物丧志	wan wu sang zhi
现世现报	xian shi xian boo
现买现卖	xian mai xian mai
现实主义	xian shi zhu yi
现炒现卖	xian chao xian mai
现身说法	xian shen shuo fa
玲珑剔透	ling long ti tou
珍禽异兽	zhen qin yi shou
珠光宝气	zhu guang bao qi
珠圆玉润	zhu yuan yu run
珠联璧合	zhu lian bi he
珠连璧合	zhu lian bi he
班门弄斧	ban men nong fu
琅琅上口	lang lang shang kou
理亏心虚	li kui xin xu
理屈词穷	li qu ci qiong
理所当然	li suo dang ran
理直气壮	li zhi qi zhuang
琳琅满目	lin lang man mu
琴棋书画	qin qi shu hua
琴瑟和谐	qin se he xie
琴瑟调和	qin se tiao he
瑕不掩瑜	xia bu yan yu
璀璨夺目	cui can duo mu
瓜熟蒂落	gua shu di luo
瓜田李下	gua tian li xia
瓢泼大雨	piao po da yu
瓮中之鳖	weng zhong zhi bie
瓮中捉鳖	weng zhong zhuo bie
瓮声瓮气	weng sheng weng qi
甘心情愿	gan xin qing yuan
甘拜下风	gan bai xia feng
甘苦与共	gan ku yu gong
甚嚣尘上	shen xiao chen shang
甜言蜜语	tian yan mi yu
甜酸苦辣	tian suan ku la
生不如死	sheng bu ru si
生不逢时	sheng bu feng shi
生儿育女	sheng er yu nu
生动活泼	sheng dong huo po
生吞活剥	sheng tun huo bo
生意兴隆	sheng yi xing long
生意盎然	sheng yi ang ran
生拉硬扯	sheng la ying che
生拉硬拽	sheng la ying zhuai
生搬硬套	sheng ban ying tao
生机勃勃	sheng ji bo bo
生机盎然	sheng ji ang ran
生杀予夺	sheng sha yu duo
生死与共	sheng si yu gong
生死之交	sheng si zhi jiao
生死关头	sheng si guan tou
生死存亡	sheng si cun wang
生死搏斗	sheng si bo dou
生死攸关	sheng si you guan
生死有命	sheng si you ming
生死未卜	sheng si wei bu
生死相依	sheng si xiang yi
生气勃勃	sheng qi bo bo
生气蓬勃	sheng qi bo bo
生灵涂炭	sheng ling tu tan
生生不息	sheng sheng bu xi
生生世世	sheng sheng shi shi
生离死别	sheng li si bie
生老病死	sheng lao bing si
生花妙笔	sheng hua miao bi
生财之路	sheng cai zhi lu
生财之道	sheng cai zhi dao
生财有道	sheng cai you dao
生龙活虎	sheng long huo hu
用兵如神	yong bing ru shen
用尽心机	yong jin xin ji
用心良苦	yong xin liang ku
用武之地	yong wu zhi di
由小见大	you xiao jian da
由来已久	you lai yi jiu
由此及彼	you ci ji bi
由浅入深	you qian ru shen
由表及里	you biao ji li
由衷之言	you zhong zhi yan
电光石火	dian guang shi huo
电闪雷鸣	dian shan lei ming
男大当婚	nan da dang hun
男女有别	nan nu you bie
男女老少	nan nu lao shao
男女老幼	nan nu lao you
男婚女嫁	nan hun nu jia
男尊女卑	nan zun nu bei
男才女貌	nan cai nu mao
男扮女装	nan ban nu zhuang
男欢女爱	nan huan nu ai
男盗女娼	nan dao nu chang
男耕女织	nan geng nu zhi
画地为牢	hua di wei lao
画虎不成	hua hu bu cheng
画虎类犬	hua hu lei quan
画蛇添足	hua she tian zu
画饼充饥	hua bing chong ji
画龙点睛	hua long dian jing
畅所欲言	chang suo yu yan
畅行无阻	chang xing wu zu
畅通无阻	chang tong wu zu
畏缩不前	wei suo bu qian
畏罪潜逃	wei zui qian tao
畏首畏尾	wei sho wei wei
留恋不舍	liu lian bu she
留有余地	liu you yu di
留连忘返	liu lian wang fan
略施小计	lue shi xiao ji
略知一二	lue zhi yi er
略知皮毛	lue zhi pi mao
略胜一筹	lue sheng yi chou
略见一斑	lue jian yi ban
略逊一筹	lue xun yi chou
略高一筹	lue gao yi chou
畸形发展	ji xing fa zhan
疏忽大意	shu hu da yi
疏而不漏	shu er bu lou
疏财仗义	shu cai zhang yi
疑信参半	yi xin can ban
疑惑不解	yi huo bu jie
疑神疑鬼	yi shen yi gui
疑难杂症	yi nan za zheng
疯疯癫癫	feng feng dian dian
疲于奔命	pi yu ben ming
疲惫不堪	pi bei bu kan
疾恶如仇	ji e ru chou
疾言厉色	ji yan li se
疾风劲草	ji feng jin cao
疾风暴雨	ji feng bao yu
疾风骤雨	ji feng zhou yu
病从口入	bing cong kou ru
病入膏肓	bing ru gao huang
病魔缠身	bing mo chan shen
症结所在	zheng jie suo zai
痛不欲生	tong bu yu sheng
痛哭流涕	tong ku liu ti
痛定思痛	tong ding si tong
痛心疾首	tong xin ji shou
痛快淋漓	tong kuai lin li
痛改前非	tong gai qian fei
痛痛快快	tong tong kuai kuai
痴人说梦	chi ren shuo meng
痴心妄想	chi xin wang xiang
狂风恶浪	kuang feng e lang
狂风暴雨	kuang feng bao yu
狂风骤雨	kuang feng zhou yu
狐假虎威	hu jia hu wei
狐朋狗党	hu peng gou dang
狐朋狗友	hu peng gou you
狐狸尾巴	hu li wei ba
狐群狗党	hu qun gou dang
狗仗人势	gou zhang ren shi
狗头军师	gou tou jun shi
狗屁不通	gou pi bu tong
狗急跳墙	gou ji tiao qiang
狗拿耗子	gou na hao zi
狗皮膏药	gou pi gao yao
狗眼看人	gou yan kan ren
狗胆包天	gou dan bao tian
狗血喷头	gou xue pen tou
狡兔三窟	jiao tu san ku
独一无二	du yi wu er
独具一格	du ju yi ge
独具匠心	du ju jiang xin
独具慧眼	du ju hui yan
独出心裁	du chu xin cai
独到之处	du dao zhi chu
独力难支	du li nan zhi
独占鳌头	du zhan ao tou
独善其身	du shan qi shen
独守空房	du shou kong fang
独当一面	du dang yi mian
独往独来	du wang du lai
独揽大权	du lan da quan
独断专行	du duan zhuan xing
独断独行	du duan du xing
独木难支	du mu nan zhi
独来独往	du lai du wang
独树一帜	du shu yi zhi
独步天下	du bu tian xia
独立王国	du li wang guo
独立自主	du li zi zhu
独辟蹊径	du pi xi jing
独霸一方	du ba yi fang
狭路相逢	xia lu xiang feng
狼吞虎咽	lang tun hu yan
狼多肉少	lang duo rou shao
狼子野心	lang zi ye xin
狼心狗肺	lang xin gou fei
狼烟四起	lang yan si qi
狼狈不堪	lang bei bu kan
狼狈为奸	lang bei wei jian
狼狈逃窜	lang bei tao cuan
狼窝虎穴	lang wo hu xue
猛虎下山	meng hu xia shan
猝不及防	cu bu ji fang
猪朋狗友	zhu peng gou you
猪狗不如	zhu gou bu ru
猫哭耗子	mao ku hao zi
献计献策	xian ji xian ce
猴年马月	hou nian ma yue
獐头鼠目	zhang tou shu mu
玉树临风	yu shu lin feng
玉洁冰清	yu jie bing qing
玉石俱焚	yu shi ju fen
玉碎瓦全	yu sui wa quan
王侯将相	wang hou jiang xiang
玩世不恭	wan shi bu gong
玩忽职守	wan hu zhi shou
玩火自焚	wan huo zi fen
玩物丧志	wan wu sang zhi
现世现报	xian shi xian boo
现买现卖	xian mai xian mai
现实主义	xian shi zhu yi
现炒现卖	xian chao xian mai
现身说法	xian shen shuo fa
玲珑剔透	ling long ti tou
珍禽异兽	zhen qin yi shou
珠光宝气	zhu guang bao qi
珠圆玉润	zhu yuan yu run
珠联璧合	zhu lian bi he
珠连璧合	zhu lian bi he
班门弄斧	ban men nong fu
琅琅上口	lang lang shang kou
理亏心虚	li kui xin xu
理屈词穷	li qu ci qiong
理所当然	li suo dang ran
理直气壮	li zhi qi zhuang
琳琅满目	lin lang man mu
琴棋书画	qin qi shu hua
琴瑟调和	qin se tiao he
瑕不掩瑜	xia bu yan yu
璀璨夺目	cui can duo mu
瓜熟蒂落	gua shu di luo
瓜田李下	gua tian li xia
瓢泼大雨	piao po da yu
瓮中之鳖	weng zhong zhi bie
瓮中捉鳖	weng zhong zhuo bie
瓮声瓮气	weng sheng weng qi
甘心情愿	gan xin qing yuan
甘拜下风	gan bai xia feng
甘苦与共	gan ku yu gong
甚嚣尘上	shen xiao chen shang
甜言蜜语	tian yan mi yu
甜酸苦辣	tian suan ku la
生不如死	sheng bu ru si
生不逢时	sheng bu feng shi
生儿育女	sheng er yu nu
生动活泼	sheng dong huo po
生吞活剥	sheng tun huo bo
生意兴隆	sheng yi xing long
生拉硬扯	sheng la ying che
生拉硬拽	sheng la ying zhuai
生搬硬套	sheng ban ying tao
生机勃勃	sheng ji bo bo
生机盎然	sheng ji ang ran
生杀予夺	sheng sha yu duo
生死与共	sheng si yu gong
生死之交	sheng si zhi jiao
生死关头	sheng si guan tou
生死存亡	sheng si cun wang
生死搏斗	sheng si bo dou
生死攸关	sheng si you guan
生死有命	sheng si you ming
生死未卜	sheng si wei bu
生死相依	sheng si xiang yi
生气勃勃	sheng qi bo bo
生气蓬勃	sheng qi bo bo
生灵涂炭	sheng ling tu tan
生生不息	sheng sheng bu xi
生生世世	sheng sheng shi shi
生离死别	sheng li si bie
生老病死	sheng lao bing si
生花妙笔	sheng hua miao bi
生财之路	sheng cai zhi lu
生财之道	sheng cai zhi dao
生财有道	sheng cai you dao
生龙活现	sheng long huo xian
生龙活虎	sheng long huo hu
用兵如神	yong bing ru shen
用尽心机	yong jin xin ji
用心良苦	yong xin liang ku
用武之地	yong wu zhi di
由小见大	you xiao jian da
由来已久	you lai yi jiu
由此及彼	you ci ji bi
由浅入深	you qian ru shen
由表及里	you biao ji li
由衷之言	you zhong zhi yan
由近及远	you jin ji yuan
电光石火	dian guang shi huo
电闪雷鸣	dian shan lei ming
男大当婚	nan da dang hun
男女平等	nan nu ping deng
男女有别	nan nu you bie
男女老少	nan nu lao shao
男女老幼	nan nu lao you
男婚女嫁	nan hun nu jia
男尊女卑	nan zun nu bei
男才女貌	nan cai nu mao
男扮女装	nan ban nu zhuang
男欢女爱	nan huan nu ai
男盗女娼	nan dao nu chang
男耕女织	nan geng nu zhi
画地为牢	hua di wei lao
画虎不成	hua hu bu cheng
画虎类犬	hua hu lei quan
画蛇添足	hua she tian zu
画饼充饥	hua bing chong ji
画龙点睛	hua long dian jing
畅所欲言	chang suo yu yan
畅行无阻	chang xing wu zu
畅通无阻	chang tong wu zu
畏缩不前	wei suo bu qian
畏罪潜逃	wei zui qian tao
畏首畏尾	wei sho wei wei
留恋不舍	liu lian bu she
留有余地	liu you yu di
留连忘返	liu lian wang fan
略施小计	lue shi xiao ji
略知一二	lue zhi yi er
略知皮毛	lue zhi pi mao
略胜一筹	lue sheng yi chou
略见一斑	lue jian yi ban
略逊一筹	lue xun yi chou
略高一筹	lue gao yi chou
疏密有致	shu mi you zhi
疏忽大意	shu hu da yi
疏而不漏	shu er bu lou
疏财仗义	shu cai zhang yi
疑惑不解	yi huo bu jie
疑神疑鬼	yi shen yi gui
疑难杂症	yi nan za zheng
疯疯癫癫	feng feng dian dian
疲于奔命	pi yu ben ming
疲惫不堪	pi bei bu kan
疾恶如仇	ji e ru chou
疾言厉色	ji yan li se
疾风劲草	ji feng jin cao
疾风暴雨	ji feng bao yu
疾风骤雨	ji feng zhou yu
病从口入	bing cong kou ru
病入膏肓	bing ru gao huang
病魔缠身	bing mo chan shen
症结所在	zheng jie suo zai
痛不欲生	tong bu yu sheng
痛哭流涕	tong ku liu ti
痛定思痛	tong ding si tong
痛彻骨髓	tong che gu sui
痛心疾首	tong xin ji shou
痛快淋漓	tong kuai lin li
痛改前非	tong gai qian fei
痛痛快快	tong tong kuai kuai
痴人说梦	chi ren shuo meng
痴心妄想	chi xin wang xiang
瘦骨伶仃	shou gu ling ding
瘦骨如柴	shou gu ru chai
瘦骨嶙峋	shou gu lin xun
登堂入室	deng tang ru shi
登峰造极	deng feng zao ji
登高一呼	deng gao yi hu
登高望远	deng gao wang yuan
白发苍苍	bai fa cang cang
白头偕老	bai tou xie lao
白头到老	bai tou dao lao
白手成家	bai shou cheng jia
白手起家	bai shou qi jia
白日做梦	bai ri zuo meng
白玉微瑕	bai yu wei xia
白玉无瑕	bai yu wu xia
白璧微瑕	bai bi wei xia
白璧无瑕	bai bi wu xia
白纸黑字	bai zhi hei zi
白衣天使	bai yi tian shi
白费口舌	bai fei kou she
白费心机	bai fei xin ji
白跑一趟	bai pao yi tang
白雪皑皑	bai xue ai ai
白面书生	bai mian shu sheng
白驹过隙	bai ju guo xi
百依百顺	bai yi bai shun
百发百中	bai fa bai zhong
百口莫辩	bai kou mo bian
百听不厌	bai ting bu yan
百孔千疮	bai kong qian chuang
百家争鸣	bai jia zheng ming
百密一疏	bai mi yi shu
百尺竿头	bai chi gan tou
百川归海	bai chuan gui hai
百年不遇	bai nian bu yu
百年之后	bai nian zhi hou
百年大计	bai nian da ji
百年好合	bai nian hao he
百年树人	bai nian shu ren
百年难遇	bai nian nan yu
百废俱兴	bai fei ju xing
百废待兴	bai fei dai xing
百思不解	bai si bu jie
百感交集	bai gan jiao ji
百战不殆	bai zhan bu dai
百战百胜	bai zhan bai sheng
百折不回	bai zhe bu hui
百折不屈	bai zhe bu qu
百折不挠	bai zhe bu nao
百无一失	bai wu yi shi
百无一用	bai wu yi yong
百无是处	bai wu shi chu
百无禁忌	bai wu jin ji
百无聊赖	bai wu liao lai
百步穿杨	bai bu chuan yang
百炼成钢	bai lian cheng gang
百般刁难	bai ban diao nan
百般奉承	bai ban feng cheng
百般折磨	bai ban zhe mo
百般责难	bai ban ze nan
百花争妍	bai hua zheng yan
百花争艳	bai hua zheng yan
百花齐放	bai hua qi fang
百读不厌	bai du bu yan
百里挑一	bai li tiao yi
百鸟朝凤	bai niao chao feng
皆大欢喜	jie da huan xi
皇亲国戚	huang qin guo qi
皓月当空	hao yue dang kong
皮开肉绽	pi kai rou zhan
皮肉之苦	pi rou zhi ku
盆满钵满	pen man bo man
监守自盗	jian shou zi dao
盖世无双	gai shi wu shuang
盖世英雄	gai shi ying xiong
盖棺定论	gai guan ding lun
盖棺论定	gai guan lun ding
盘根究底	pan gen jiu di
盘根错节	pan gen cuo jie
盛况空前	sheng kuang kong qian
盛情难却	sheng qing nan que
盛极一时	sheng ji yi shi
盛极必衰	sheng ji bi shuai
盛气凌人	sheng qi ling ren
盛行一时	sheng xing yi shi
目不忍睹	mu bu ren du
目不斜视	mu bu xie shi
目不暇接	mu bu xia jie
目不识丁	mu bu shi ding
目不转睛	mu bu zhuan jing
目中无人	mu zhong wu ren
目光如炬	mu guang ru ju
目光炯炯	mu guang jiong jiong
目光短浅	mu guang duan qian
目光远大	mu guang yuan da
目无尊长	mu wu zun zhang
目无法纪	mu wu fa ji
目无王法	mu wu wang fa
目瞪口呆	mu deng kou dai
目空一切	mu kong yi qie
盲人摸象	mang ren mo xiang
盲人瞎马	mang ren xia ma
盲目乐观	mang mu le guan
盲目崇拜	mang mu chong bai
直入云霄	zhi ru yun xiao
直奔主题	zhi ben zhu ti
直截了当	zhi jie liao dang
直抒己见	zhi shu ji jian
直抒胸臆	zhi shu xiong yi
直捣黄龙	zhi dao huang long
直接了当	zhi jie liao dang
直来直去	zhi lai zhi qu
直言不讳	zhi yan bu hui
相互尊重	xiang hu zun zhong
相亲相爱	xiang qin xiang ai
相依为命	xiang yi wei ming
相去无几	xiang qu wu ji
相反相成	xiang fan xiang cheng
相安无事	xiang an wu shi
相对无言	xiang dui wu yan
相差无几	xiang cha wu ji
相形失色	xiang xing shi se
相形见绌	xiang xing jian chu
相得益彰	xiang de yi zhang
相持不下	xiang chi bu xia
相提并论	xiang ti bing lun
相敬如宾	xiang jing ru bin
相映成趣	xiang ying cheng qu
相机行事	xiang ji xing shi
相濡以沫	xiang ru yi mo
相生相克	xiang sheng xiang ke
相知恨晚	xiang zhi hen wan
相继而至	xiang ji er zhi
相见恨晚	xiang jian hen wan
相视无言	xiang shi wu yan
相视而笑	xiang shi er xiao
相貌堂堂	xiang mao tang tang
相辅相成	xiang fu xiang cheng
相逢恨晚	xiang feng hen wan
相顾无言	xiang gu wu yan
省吃俭用	sheng chi jian yong
眉开眼笑	mei kai yan xiao
眉来眼去	mei lai yan qu
眉清目秀	mei qing mu xiu
眉目传情	mei mu chuan qing
眉目如画	mei mu ru hua
眉眼传情	mei yan chuan qing
眉飞眼笑	mei fei yan xiao
眉飞色舞	mei fei se wu
看不上眼	kan bu shang yan
看人下菜	kan ren xia cai
看家本领	kan jia ben ling
看破红尘	kan po hong chen
看风使舵	kan feng shi duo
看风转舵	kan feng zhuan duo
真伪难辨	zhen wei nan bian
真假难辨	zhen jia nan bian
真凭实据	zhen ping shi ju
真刀真枪	zhen dao zhen qiang
真心实意	zhen xin shi yi
真心真意	zhen xin zhen yi
真心诚意	zhen xin cheng yi
真情实意	zhen qing shi yi
相形失色	xiang xing shi se
相形见绌	xiang xing jian chu
相得益彰	xiang de yi zhang
相持不下	xiang chi bu xia
相提并论	xiang ti bing lun
相敬如宾	xiang jing ru bin
相映成趣	xiang ying cheng qu
相机行事	xiang ji xing shi
相濡以沫	xiang ru yi mo
相生相克	xiang sheng xiang ke
相生相成	xiang sheng xiang cheng
相知恨晚	xiang zhi hen wan
相继而至	xiang ji er zhi
相见恨晚	xiang jian hen wan
相视无言	xiang shi wu yan
相视而笑	xiang shi er xiao
相貌堂堂	xiang mao tang tang
相辅相成	xiang fu xiang cheng
相逢恨晚	xiang feng hen wan
相顾无言	xiang gu wu yan
省吃俭用	sheng chi jian yong
眉开眼笑	mei kai yan xiao
眉来眼去	mei lai yan qu
眉清目秀	mei qing mu xiu
眉目传情	mei mu chuan qing
眉眼传情	mei yan chuan qing
眉飞眼笑	mei fei yan xiao
眉飞色舞	mei fei se wu
看不上眼	kan bu shang yan
看人下菜	kan ren xia cai
看家本事	kan jia ben shi
看家本领	kan jia ben ling
看破红尘	kan po hong chen
看风使舵	kan feng shi duo
真伪难辨	zhen wei nan bian
真假难辨	zhen jia nan bian
真凭实据	zhen ping shi ju
真刀真枪	zhen dao zhen qiang
真心实意	zhen xin shi yi
真心真意	zhen xin zhen yi
真心诚意	zhen xin cheng yi
真情实意	zhen qing shi yi
真情实感	zhen qing shi gan
真才实学	zhen cai shi xue
真枪实弹	zhen qiang shi dan
真相大白	zhen xiang da bai
真真假假	zhen zhen jia jia
真知灼见	zhen zhi zhuo jian
眼不转睛	yan bu zhuan jing
眼尖手快	yan jian shou kuai
眼明心亮	yan ming xin liang
眼明手快	yan ming shou kuai
眼泪汪汪	yan lei wang wang
眼疾手快	yan ji shou kuai
眼花缭乱	yan hua liao luan
眼观六路	yan guan liu lu
眼高手低	yan gao shou di
睚眦必报	ya zi bi bao
睡眼惺忪	shui yan xing song
睡眼朦胧	shui yan meng long
睹物思人	du wu si ren
瞎子摸象	xia zi mo xiang
瞎说八道	xia shuo ba dao
瞒上欺下	man shang qi xia
瞒天过海	man tian guo hai
瞠目结舌	cheng mu jie she
瞪目结舌	deng mu jie she
瞬息万变	shun xi wan bian
瞬息之间	shun xi zhi jian
瞻前顾后	zhan qian gu hou
矛盾重重	mao dun chong chong
矢口否认	shi kou fou ren
矢志不渝	shi zhi bu yu
矢志不移	shi zhi bu yi
知书达理	zhi shu da li
知书达礼	zhi shu da li
知人善任	zhi ren shan ren
知冷知热	zhi leng zhi re
知己知彼	zhi ji zhi bi
知彼知己	zhi bi zhi ji
知恩必报	zhi en bi bao
知情不报	zhi qing bu bao
知情达理	zhi qing da li
知无不言	zhi wu bu yan
知易行难	zhi yi xing nan
知根知底	zhi gen zhi di
知法犯法	zhi fa fan fa
知行合一	zhi xing he yi
知足常乐	zhi zu chang le
知遇之恩	zhi yu zhi en
知错就改	zhi cuo jiu gai
知难而进	zhi nan er jin
知难而退	zhi nan er tui
矫揉造作	jiao rou zao zuo
矫枉过正	jiao wang guo zheng
短兵相接	duan bing xiang jie
短小精干	duan xiao jing gan
短小精悍	duan xiao jing han
短斤缺两	duan jin que liang
矮小精悍	ai xiao jing han
石沉大海	shi chen da hai
石破天惊	shi po tian jing
砍瓜切菜	kan gua qie cai
破口大骂	po kou da ma
破口痛骂	po kou tong ma
破旧立新	po jiu li xin
破格录用	po ge lu yong
破格提拔	po ge ti ba
破涕为笑	po ti wei xiao
破烂不堪	po lan bu kan
破破烂烂	po po lan lan
破竹之势	po zhu zhi shi
破绽百出	po zhan bai chu
破罐破摔	po guan po shuai
破釜沉舟	po fu chen zhou
破铜烂铁	po tong lan tie
破镜重圆	po jing chong yuan
破门而入	po men er ru
破门而出	po men er chu
破除迷信	po chu mi xin
砸锅卖铁	za guo mai tie
硕大无比	shuo da wu bi
硕果仅存	shuo guo jin cun
硕果累累	shuo guo lei lei
硝烟弥漫	xiao yan mi man
硬着头皮	ying zhe tou pi
确凿不移	que zao bu yi
确确实实	que que shi shi
碌碌无为	lu lu wu wei
碍手碍脚	ai shou ai jiao
碧波荡漾	bi bo dang yang
碧空万里	bi kong wan li
碧空如洗	bi kong ru xi
碧血丹心	bi xue dan xin
磕磕绊绊	ke ke ban ban
磨刀霍霍	mo dao huo huo
磨嘴皮子	mo zui pi zi
磨拳擦掌	mo quan ca zhang
磨磨蹭蹭	mo mo ceng ceng
礼义廉耻	li yi lian chi
礼仪之邦	li yi zhi bang
礼尚往来	li shang wang lai
礼贤下士	li xian xia shi
祖传秘方	zu chuan mi fang
祖祖辈辈	zu zu bei bei
神不守舍	shen bu shou she
神乎其技	shen hu qi ji
神乎其神	shen hu qi shen
神出鬼没	shen chu gui mo
神志不清	shen zhi bu qing
神态自若	shen tai zi ruo
神情恍惚	shen qing huang hu
神情自若	shen qing zi ruo
神智不清	shen zhi bu qing
神机妙算	shen ji miao suan
神来之笔	shen lai zhi bi
神气十足	shen qi shi zu
神气活现	shen qi huo xian
神清气爽	shen qing qi shuang
神秘莫测	shen mi mo ce
神经过敏	shen jing guo min
神色自如	shen se zi ru
神色自若	shen se zi ruo
神通广大	shen tong guang da
神采奕奕	shen cai yi yi
神采焕发	shen cai huan fa
神采飞扬	shen cai fei yang
神闲气定	shen xian qi ding
神鬼莫测	shen gui mo ce
神魂颠倒	shen hun dian dao
祸不单行	huo bu dan xing
祸从口出	huo cong kou chu
祸从天降	huo cong tian jiang
祸国殃民	huo guo yang min
祸在旦夕	huo zai dan xi
祸福相依	huo fu xiang yi
禀性难移	bing xing nan yi
福如东海	fu ru dong hai
福寿双全	fu shou shuang quan
福无双至	fu wu shuang zhi
福星高照	fu xing gao zhao
离乡背井	li xiang bei jing
离心离德	li xin li de
离经叛道	li jing pan dao
离题万里	li ti wan li
禽兽不如	qin shou bu ru
秀外慧中	xiu wai hui zhong
秀色可餐	xiu se ke can
私心杂念	si xin za nian
秉公办事	bing gong ban shi
秉公办理	bing gong ban li
秉公无私	bing gong wu si
秋后算帐	qiu hou suan zhang
秋后算账	qiu hou suan zhang
秋毫无犯	qiu hao wu fan
秋风落叶	qiu feng luo ye
秋高气爽	qiu gao qi shuang
科教兴国	ke jiao xing guo
科班出身	ke ban chu shen
秘而不宣	mi er bu xuan
秦晋之好	qin jin zhi hao
秩序井然	zhi xu jing ran
积习难改	ji xi nan gai
积劳成疾	ji lao cheng ji
积劳成病	ji lao cheng bing
积土成山	ji shui wei shan
积少成多	ji shao cheng duo
积年累月	ji nian lei yue
积忧成疾	ji you cheng ji
积沙成塔	ji sha cheng ta
积重难返	ji zhong nan fan
积非成是	ji fei cheng shi
称兄道弟	cheng xiong dao di
称心如意	chen xin ru yi
称心满意	chen xin man yi
称王称霸	cheng wang cheng ba
移山倒海	yi shan dao hai
移花接木	yi hua jie mu
移风易俗	yi feng yi su
稀世之宝	xi shi zhi bao
稀奇古怪	xi qi gu guai
稀稀拉拉	xi xi la la
稀稀落落	xi xi luo luo
稀里哗啦	xi li hua la
稀里糊涂	xi li hu tu
稍纵即逝	shao zong ji shi
稍胜一筹	shao sheng yi chou
稍逊一筹	shao xun yi chou
稳如泰山	wen ru tai shan
稳如磐石	wen ru pan shi
稳扎稳打	wen zha wen da
稳操胜券	wen cao sheng quan
稳操胜算	wen cao sheng suan
稳步前进	wen bu qian jin
稳稳当当	wen wen dang dang
稳若泰山	wen ruo tai shan
穷乡僻壤	qiong xiang pi rang
穷兵黩武	qiong bing du wu
穷凶极恶	qiong xiong ji e
穷则思变	qiong ze si bian
穷困潦倒	qiong kun liao dao
穷奢极侈	qiong she ji chi
穷奢极欲	qiong she ji yu
穷寇勿追	qiong kou wu zhui
穷寇莫追	qiong kou mo zhui
穷山僻壤	qiong shan pi rang
穷山恶水	qiong shan e shui
穷年累月	qiong nian lei yue
穷愁潦倒	qiong chou liao dao
穷极无聊	qiong ji wu liao
穷根究底	qiong gen jiu di
穷追不舍	qiong zhui bu she
穷追猛打	qiong zhui meng da
穷途末路	qiong tu mo lu
穷途潦倒	qiong tu liao dao
空中楼阁	kong zhong lou ge
空前绝后	kong qian jue hou
空口无凭	kong kou wu ping
空口白话	kong kou bai hua
空头支票	kong tou zhi piao
空有其表	kong you qi biao
空洞无物	kong dong wu wu
空穴来风	kong xue lai feng
空空如也	kong kong ru ye
空空荡荡	kong kong dang dang
空话连篇	kong hua lian pian
穿凿附会	chuan zao fu hui
穿针引线	chuan zhen yin xian
突如其来	tu ru qi lai
突然袭击	tu ran xi ji
突飞猛进	tu fei meng jin
窃窃私议	qie qie si yi
窃窃私语	qie qie si yu
窈窕淑女	yao tiao shu nu
窗明几净	chuang ming ji jing
窥见一斑	kui jian yi ban
立功赎罪	li gong shu zui
立场不稳	li chang bu wen
立竿见影	li gan jian ying
立足之地	li zu zhi di
立身处世	li shen chu shi
立锥之地	li zhui zhi di
站不住脚	zhan bu zhu jiao
站稳脚跟	zhan wen jiao gen
童叟无欺	tong sou wu qi
童心未泯	tong xin wei min
童言无忌	tong yan wu ji
童颜鹤发	tong yan he fa
竭尽全力	jie jin quan li
竭尽心力	jie jin xin li
竭泽而渔	jie ze er yu
端端正正	duan duan zheng zheng
竹篮打水	zhu lan da shui
笑容可掬	xiao rong ke ju
笑容满面	xiao rong man mian
笑而不答	xiao er bu da
笑逐颜开	xiao zhu yan kai
笑里藏刀	xiao li cang dao
笔下生花	bi xia sheng hua
笔走龙蛇	bi zou long she
笨口拙舌	ben kou zhuo she
笨嘴拙舌	ben zui zhuo she
笨嘴笨舌	ben zui ben she
笨头笨脑	ben tou ben nao
笨手笨脚	ben shou ben jiao
笨鸟先飞	ben niao xian fei
笼中之鸟	long zhong zhi niao
笼络人心	long luo ren xin
等米下锅	deng mi xia guo
等量齐观	deng liang qi guan
等闲之辈	deng xian zhi bei
等闲视之	deng xian shi zhi
筋疲力尽	jing pi li jin
筋疲力竭	jin pi li jie
答非所问	da fei suo wen
筚路蓝缕	bi lu lan lu
简单明了	jian dan ming liao
简明扼要	jian ming e yao
简而言之	jian er yan zhi
管中窥豹	guan zhong kui bao
箭不虚发	jian bu xu fa
箭在弦上	jian zai xian shang
箭拔弩张	jian ba nu zhang
粉墨登场	fen mo deng chang
粉妆玉砌	fen zhuang yu qi
粉身碎骨	fen shen sui gu
粉饰太平	fen shi tai ping
粗中有细	cu zhong you xi
粗制滥造	cu zhi lan zao
粗声粗气	cu sheng cu qi
粗心大意	cu xin da yi
粗枝大叶	cu zhi da ye
粗茶淡饭	cu cha dan fan
粥少僧多	zhou shao seng duo
精兵强将	jing bing qiang jiang
精兵简政	jing bing jian zheng
精力充沛	jing li chong pei
精卫填海	jing wei tian hai
精妙绝伦	jing miao jue lun
精忠报国	jing zhong bao guo
精打细算	jing da xi suan
精明强干	jing ming qiang gan
精明能干	jing ming neng gan
精疲力尽	jing pi li jin
精疲力竭	jing pi li jie
精益求精	jing yi qiu jing
精神恍惚	jing shen huang hu
精神抖擞	jing shen dou sou
精神涣散	jing shen huan san
精神焕发	jing shen huan fa
精神百倍	jing shen bai bei
精细入微	jing xi ru wei
精美绝伦	jing mei jue lun
精耕细作	jing geng xi zuo
精诚团结	jing cheng tuan jie
精诚所至	jing cheng suo zhi
精雕细刻	jing diao xi ke
糊里糊涂	hu li hu tu
糖衣炮弹	tang yi pao dan
糟糠之妻	zao kang zhi qi
素不相识	su bu xiang shi
素昧平生	su mei ping sheng
素未谋面	su wei mou mian
索然无味	suo ran wu wei
紧要关头	jin yao guan tou
紧追不舍	jin zhui bu she
紧锣密鼓	jin luo mi gu
紫气东来	zi qi dong lai
累死累活	lei si lei huo
累见不鲜	lei jian bu xian
絮絮叨叨	xu xu dao dao
繁文缛节	fan wen ru jie
繁花似锦	fan hua si jin
繁荣兴旺	fan rong xing wang
繁荣富强	fan rong fu qiang
繁荣昌盛	fan rong chang sheng
纠缠不清	jiu chan bu qing
红光满面	hong guang man mian
红得发紫	hong de fa zi
红杏出墙	hong xing chu qiang
红白喜事	hong bai xi shi
红红火火	hong hong huo huo
红颜薄命	hong yan bo ming
纤尘不染	xian chen bu ran
约定俗成	yue ding su cheng
约法三章	yue fa san zhang
纨绔子弟	wan ku zi di
纲举目张	gang ju mu zhang
纵情欢乐	zong qing huan le
纵横交错	zong heng jiao cuo
纵横四海	zong heng si hai
纵横天下	zong heng tian xia
纵虎归山	zong hu gui shan
纷纷扬扬	fen fen yang yang
纷纷议论	fen fen yi lun
纷至沓来	fen zhi ta lai
纸上谈兵	zhi shang tan bing
纸短情长	zhi duan qing chang
纸醉金迷	zhi zui jin mi
纹丝不动	wen si bu dong
细嚼慢咽	xi jiao man yan
细声细气	xi sheng xi qi
细枝末节	xi zhi mo jie
细水长流	xi shui chang liu
细皮嫩肉	xi pi nen rou
终身大事	zhong shen da shi
经久不息	jing jiu bu xi
经久不衰	jing jiu bu shuai
经年累月	jing nian lei yue
经验之谈	jing yan zhi tan
经验教训	jing yan jiao xun
结党营私	jie dang ying si
结发夫妻	jie fa fu qi
结结实实	jie jie shi shi
结结巴巴	jie jie ba ba
绕梁三日	rao liang san ri
绘声绘色	hui sheng hui se
绚丽多姿	xuan li duo zi
绚丽多彩	xuan li duo cai
络绎不绝	luo yi bu jue
绝世佳人	jue shi jia ren
绝世无双	jue shi wu shuang
绝代佳人	jue dai jia ren
绝口不提	jue kou bu ti
绝处逢生	jue chu feng sheng
绝无仅有	jue wu jin you
绝路逢生	jue lu feng sheng
绝顶聪明	jue ding cong ming
绞尽脑汁	jiao jin nao zhi
统一口径	tong yi kou jing
统一战线	tong yi zhan xian
统筹兼顾	tong chou jian gu
绣花枕头	xiu hua zhen tou
继往开来	ji wang kai lai
继承衣钵	ji cheng yi bo
绰绰有余	chuo chuo you yu
绳之以法	sheng zhi yi fa
绳锯木断	sheng ju mu duan
维妙维肖	wei miao wei xiao
绵延不断	mian yan bu duan
绵延不绝	mian yan bu jue
绵绵不断	mian mian bu duan
绵绵不绝	mian mian bu jue
绵里藏针	mian li cang zhen
绿林好汉	lu lin hao han
绿水青山	lu shui qing shan
绿草如茵	lu cao ru yin
缄口不言	jian kou bu yan
缓兵之计	huan bing zhi ji
缘木求鱼	yuan mu qiu yu
缩头缩脑	suo tou suo nao
缩成一团	suo cheng yi tuan
缩手缩脚	suo shou suo jiao
缺一不可	que yi bu ke
缺吃少穿	que chi xhao chuan
缺斤短两	que jin duan liang
缺衣少食	que yi shao shi
罄竹难书	qing zhu nan shu
网开一面	wang kai yi mian
罗织罪名	luo zhi zui ming
罪不容诛	zui bu rong zhu
罪加一等	zui jia yi deng
罪大恶极	zui da e ji
罪孽深重	zui nie shen zhong
罪恶昭彰	zui e zhao zhang
罪恶昭著	zui e zhao zhu
罪恶滔天	zui e tao tian
罪有应得	zui you ying de
罪该万死	zui gai wan si
罪魁祸首	zui kui huo shou
置之不理	zhi zhi bu li
置之不顾	zhi zhi bu gu
置之度外	zhi zhi du wai
置之死地	zhi zhi si di
置之脑后	zhi zhi nao hou
置之高阁	zhi zhi gao ge
置若罔闻	zhi ruo wang wen
置身事外	zhi shen shi wai
置身其中	zhi shen qi zhong
羊入虎口	yang ru hu kou
羊头狗肉	yang tou gou rou
羊肠小道	yang chang xiao dao
美不胜收	mei bu sheng shou
美中不足	mei zhong bu zu
美其名曰	mei qi ming yue
美味佳肴	mei wei jia yao
美轮美奂	mei lun mei huan
美酒佳肴	mei jiu jia yao
羞愧难当	xiu kui nan dang
羞羞答答	xiu xiu da da
群情激昂	qun qing ji ang
群情鼎沸	qun qing ding fei
群策群力	qun ce qun li
群芳争艳	qun fang zheng yan
群英荟萃	qun ying hui cui
群贤毕至	qun xian bi zhi
群起攻之	qun qi gong zhi
群起攻击	qun qi gong ji
群雄逐鹿	qun xiong zhu lu
群魔乱舞	qun mo luan wu
群龙无首	qun long wu shou
羽毛丰满	yu mao feng man
羽毛未丰	yu mao wei feng
羽翼丰满	yu yi feng man
翘首以待	qiao shou yi dai
翩翩少年	pian pian shao nian
翩翩起舞	pian pian qi wu
翩翩风度	pian pian feng du
翻云覆雨	fan yun fu yu
翻天覆地	fan tian fu di
翻山越岭	fan shan yue ling
翻手为云	fan shou wei yun
翻来复去	fan lai fu qu
翻来覆去	fan lai fu qu
翻江倒海	fan jiang dao hai
翻然悔悟	fan ran hui wu
翻箱倒柜	fan xiang dao gui
翻脸无情	fan lian wu qing
耀武扬威	yao wu yang wei
老于世故	lao yu shi gu
老奸巨滑	lao jian ju hua
老奸巨猾	lao jian ju hua
老实巴交	lao shi ba jiao
老弱妇孺	lao ruo fu ru
老弱残兵	lao ruo can bing
老弱病残	lao ruo can bing
老当益壮	lao dang yi zhuang
老态龙钟	lao tai long zhong
老成持重	lao cheng chi zhong
老气横秋	lao qi heng qiu
老泪纵横	lao lei zong heng
老王卖瓜	lao wang mai gua
老生常谈	lao sheng chang tan
老老实实	lao lao shi shi
老老少少	lao lao shao shao
老而弥坚	lao er mi jian
老调重弹	lao diao zhong dan
老调重谈	lao diao chong tan
老谋深算	lao mou shen suan
老马识途	lao ma shi tu
老骥伏枥	lao ji fu li
而立之年	er li zhi nian
耍两面派	shua liang mian pai
耍嘴皮子	shua zui pi zi
耐人寻味	nai ren xun wei
耳听八方	er ting ba fang
耳提面命	er ti mian ming
耳根清净	er gen qing jing
耳濡目染	er ru mu ran
耳熟能详	er shu neng xiang
耳目一新	er mu yi xin
耳聋眼花	er long yan hua
耳聪目明	er cong mu ming
耳闻目染	er wen mu ran
耳闻目睹	er wen mu du
耸人听闻	song ren ting wen
耿耿于怀	geng geng yu huai
聊以自慰	liao yi zi wei
聊胜于无	liao sheng yu wu
聚众滋事	ju zhong zi shi
聚少成多	ju shao cheng duo
聚沙成塔	ju sha cheng ta
聚精会神	ju jing hui shen
聚精凝神	ju jing ning shen
聪明伶俐	cong ming ling li
聪明才智	cong ming cai zhi
聪明睿智	cong ming rui zhi
聪明绝顶	cong ming jue ding
聪明能干	cong ming neng gan
聪明过人	cong ming guo ren
肃然起敬	su ran qi jing
肆意妄为	si yi wang wei
肆意横行	si yi heng xing
肆无忌惮	si wu ji dan
肆虐横行	si nue heng xing
肝肠寸断	gan chang cun duan
肝胆相照	gan dan xiang zhao
肝脑涂地	gan nao tu di
肥头大耳	fei tou da er
肩负重任	jian fu zhong ren
肺腑之言	fei fu zhi yan
胆大包天	dan da bao tian
胆大妄为	dan da wang wei
胆大心细	dan da xin xi
胆小如鼠	dan xiao ru shu
胆小怕事	dan xiao pa shi
胆战心惊	dan zhan xin jing
胆颤心惊	dan chan xin jing
背井离乡	bei jing li xiang
背信弃义	bei xin qi yi
背信负义	bei xin fu yi
背水一战	bei shui yi zhan
背道而驰	bei dao er chi
胜人一筹	sheng ren yi chou
胜利在望	sheng li zai wang
胡作非为	hu zuo fei wei
胡吃海喝	hu chi hai he
胡思乱想	hu si luan xiang
胡搅蛮缠	hu jiao man chan
胡编乱造	hu bian luan zao
胡言乱语	hu yan luan yu
胡说八道	hu shuo ba dao
胯下之辱	kua xia zhi ru
胸中有数	xiong zhong you shu
胸怀大志	xiong huai da zhi
胸无城府	xiong wu cheng fu
胸无大志	xiong wu da zhi
胸无点墨	xiong wu dian mo
胸有成竹	xiong you cheng zhu
能上能下	neng shang neng xia
能伸能屈	neng shen neng qu
能屈能伸	neng qu neng shen
能工巧匠	neng gong qiao jiang
能文能武	neng wen neng wu
能歌善舞	neng ge shan wu
能者为师	neng zhe wei shi
能者多劳	neng zhe duo lao
能言善辩	neng yan shan bian
能言善道	neng yan shan dao
能说会道	neng shuo hui dao
脉脉含情	mo mo han qing
脍炙人口	kuai zhi ren kou
脑满肠肥	nao man chang fei
脚踏实地	jiao ta shi di
脱口而出	tuo kou er chu
脱胎换骨	tuo tai huan gu
脱颖而出	tuo ying er chu
脸红耳赤	lian hong er chi
腥风血雨	xing feng xue yu
腰缠万贯	yao chan wan guan
腹背受敌	fu bei shou di
腾云驾雾	teng yun jia wu
腾空而起	teng kong er qi
膀大腰圆	bang da yao yuan
自上而下	zi shang er xia
自下而上	zi xia er shang
自不待言	zi bu dai yan
自不量力	zi bu liang li
自产自销	zi chan zi xiao
自以为是	zi yi wei shi
自作主张	zi zuo zhu zhang
自作多情	zi zuo duo qing
自作聪明	zi zuo cong ming
自作自受	zi zuo zi shou
自力更生	zi li geng sheng
自卖自夸	zi mai zi kua
自取其咎	zi qu qi jiu
自取灭亡	zi qu mie wang
自吹自捧	zi chui zi peng
自吹自擂	zi chui zi lei
自告奋勇	zi gao fen yong
自命不凡	zi ming bu fan
自命清高	zi ming qing gao
自圆其说	zi yuan qi shuo
自始至终	zi shi zhi zhong
自学成才	zi xue cheng cai
自寻死路	zi xun si lu
自寻烦恼	zi xun fan nao
自强不息	zi qiang bu xi
自得其乐	zi de qi le
自怨自艾	zi yuan zi yi
自惭形秽	zi can xing hui
自愧不如	zi kui bu ru
自愧弗如	zi kui fu ru
自成一家	zi cheng yi jia
自成一格	zi cheng yi ge
自我吹嘘	zi wo chui xu
自我安慰	zi wo an wei
自我批评	zi wo pi ping
自我标榜	zi wo biao bang
自我欣赏	zi wo xin shang
自我牺牲	zi wo xi sheng
自我表现	zi wo biao xian
自我解嘲	zi wo jie chao
自我陶醉	zi wo tao zui
自找麻烦	zi zhao ma fan
自投罗网	zi tou luo wang
自报家门	zi bao jia men
自掘坟墓	zi jue fen mu
自暴自弃	zi bao zi qi
自欺欺人	zi qi qi ren
自求多福	zi qiu duo fu
自然而然	zi ran er ran
自甘堕落	zi gan duo luo
自生自灭	zi sheng zi mie
自由放任	zi you fang ren
自由散漫	zi you san man
自由自在	zi you zi zai
自相残杀	zi xiang can sha
自相矛盾	zi xiang mao dun
自知之明	zi zhi zhi ming
自私自利	zi si zi li
自立门户	zi li men hu
自给自足	zi ji zi zu
自行其是	zi xing qi shi
自视甚高	zi shi shen gao
自觉自愿	zi jue zi yuan
自言自语	zi yan zi yu
自讨没趣	zi tao mei qu
自讨苦吃	zi tao ku chi
自说自话	zi shuo zi hua
自负盈亏	zi fu ying kui
自身难保	zi shen nan bao
自轻自贱	zi qing zi jian
自顾不暇	zi gu bu xia
自食其力	zi shi qi li
自食其果	zi shi qi guo
自食其言	zi shi qi yan
自高自大	zi gao zi da
自鸣得意	zi ming de yi
臭不可闻	chou bu ke wen
臭名昭彰	chou ming zhao zhang
臭名昭著	chou ming zhao zhu
臭名远扬	chou ming yuan yang
臭味相投	xiu wei xiang tou
至亲好友	zhi qin hao you
至关重要	zhi guan zhong yao
至善至美	zhi shan zhi mei
至死不变	zhi si bu bian
至死不屈	zhi si bu qu
至死不悟	zhi si bu wu
至死不渝	zhi si bu yu
至理名言	zhi li ming yan
至高无上	zhi gao wu shang
舆论哗然	yu lun hua ran
舌剑唇枪	she jian chun qiang
舌战群儒	she zhan qun ru
舍命救人	she ming jiu ren
舍己为人	she ji wei ren
舍己为公	she ji wei gong
舍己救人	she ji jiu ren
舍我其谁	she wo qi shui
舍本求末	she ben qiu mo
舍本逐末	she ben zhu mo
舍生取义	she shen qu yi
舍生忘死	she sheng wang si
舍身为国	she shen wei guo
舍身取义	she shen qu yi
舍身成仁	she shen cheng ren
舍车保帅	she ju bao shuai
舍近求远	she jin qiu yuan
舐犊情深	shi du qing shen
舞文弄墨	wu wen nong mo
舟车劳顿	zhou che lao dun
良师益友	liang shi yi you
良心发现	liang xin fa xian
良药苦口	liang yao ku kou
良莠不一	liang you bu yi
良莠不分	liang you bu fen
良莠不齐	liang you bu qi
良辰吉日	liang chen ji ri
良辰美景	liang chen mei jing
艰苦创业	jian ku chuang ye
艰苦卓绝	jian ku zhuo jue
艰苦奋斗	jian ku fen dou
艰苦朴素	jian ku pu su
艰难困苦	jian nan kun ku
艰难曲折	jian nan qu zhe
艰难险阻	jian nan xian zu
色厉内荏	se li nei ren
色胆包天	se dan bao tian
艺高胆大	yi gao dan da
节哀顺变	jie ai shun bian
节外生枝	jie wai sheng zhi
节节胜利	jie jie sheng li
节节败退	jie jie bai tui
节衣缩食	jie yi suo shi
芒刺在背	mang ci zai bei
花前月下	hua qian yue xia
花团锦簇	hua tuan jin cu
花天酒地	hua tian jiu di
花好月圆	hua hao yue yuan
花容月貌	hua rong yue mao
花拳绣腿	hua quan xiu tui
花枝招展	hua zhi zhao zhan
花样年华	hua yang nian hua
花样翻新	hua yang fan xin
花甲之年	hua jia zhi nian
花红柳绿	hua hong liu lu
花花世界	hua hua shi jie
花花公子	hua hua gong zi
花花绿绿	hua hua lu lu
花落谁家	hua luo shui jia
花言巧语	hua yan qiao yu
花里胡哨	hua li hu shao
花香鸟语	hua xiang niao yu
芸芸众生	yun yun zhong sheng
苍松翠柏	cang song cui bai
苍白无力	ang bai bui li
苍翠欲滴	cang cui yu di
苛捐杂税	ke juan za shui
苟且偷安	gou qie tou an
苟且偷生	gou qie tou sheng
苟延残喘	gou yan can chuan
若即若离	ruo ji ruo li
若无其事	ruo wu qi shi
若有所失	ruo you suo shi
若有所思	ruo you suo si
若有若无	ruo you ruo wu
若隐若现	ruo yin ruo xian
苦不堪言	ku bu kan yan
苦中作乐	ku zhong zuo le
苦口婆心	ku kou po xin
苦大仇深	ku da chou shen
苦尽甘来	ku jin gan lai
苦尽甜来	ku jin tian lai
苦心经营	ku xin jing ying
苦思冥想	ku si ming xiang
苦海无边	ku hai wu bian
英勇不屈	ying yong bu qu
英勇善战	ying yong shan zhan
英勇顽强	ying yong wan qiang
英姿勃勃	ying zi bo bo
英姿勃发	ying zi bo fa
英姿焕发	ying zi huan fa
英姿飒爽	ying zi sa shuang
英明果断	ying ming guo duan
英雄好汉	ying xiong hao han
英雄本色	ying xiong ben se
英雄气短	ying xiong qi duan
英雄豪杰	ying xiong hao jie
英雄辈出	ying xong bei chu
茁壮成长	zhuo zhuang cheng zhang
茅塞顿开	mao se dun kai
茫无头绪	mang wu tou xu
茫然不解	mang ran bu jie
茫然失措	mang ran shi cuo
茫然无知	mang ran wu zhi
茫然若失	mang ran ruo shi
茶余饭后	cha yu fan hou
荆棘丛生	jing ji cong sheng
草木皆兵	cao mu jie bing
草率了事	cao shuai liao shi
草率从事	cao shuai cong shi
草率行事	cao shuai xing shi
草船借箭	cao chuan jie jian
草草了事	cao cao liao shi
草菅人命	cao jian ren ming
草长莺飞	cao zhang ying fei
荒山野岭	huang shan ye ling
荒无人烟	huang wu ren yan
荒淫无度	huang yin wu du
荒淫无耻	huang yin wu chi
荒淫无道	huang yin wu dao
荒诞不经	huang dan bu jing
荒诞无稽	huang dan wu ji
荒谬绝伦	huang miu jue lun
荒郊野外	huang jiao ye wai
荡气回肠	dang qi hui chang
荡然无存	dang ran wu cun
荣华富贵	rong hua fu gui
荣辱与共	rong ru yu gong
荣辱得失	rong ru de shi
药到病除	yao dao bing chu
荷枪实弹	he qiang shi dan
莘莘学子	shen shen xue zi
莫名其妙	mo ming qi miao
莫测高深	mo ce gao shen
莫衷一是	mo zhong yi shi
莫逆之交	mo ni zhi jiao
莺歌燕舞	ying ge yan wu
菩萨心肠	pu sa xin chang
萍水相逢	ping shui xiang feng
萎靡不振	wei mi bu zhen
营私舞弊	ying si wu bi
萧规曹随	xiao gui cao sui
落井下石	luo jing xia shi
落叶归根	luo ye gui gen
落叶知秋	luo ye zhi qiu
落地生根	luo di sheng gen
落花流水	luo hua liu shui
落英缤纷	luo ying bin fen
落荒而走	luo huang er zou
落荒而逃	luo huang er tao
落落大方	luo luo da fang
著作等身	zhu zuo deng shen
葱葱郁郁	cong cong yu yu
蒙冤受屈	meng yuan shou qu
蒙在鼓里	meng zai gu li
蒙头转向	meng tou zhuan xiang
蒙昧无知	meng mei wu zhi
蒙混过关	meng hun guo guan
蒸蒸日上	zheng zheng ri shang
蓄谋已久	xu mou yi jiu
蓬头垢面	peng tou gou mian
蓬头散发	peng tou san fa
蓬荜生辉	peng bi sheng hui
蔚为大观	wei wei da guan
蔚然成风	wei ran cheng feng
薄利多销	bo li duo xiao
藏头露尾	cang tou lu wei
藏污纳垢	cang wu na gou
藏龙卧虎	cang long wo hu
藕断丝连	ou duan si lian
虎口余生	hu kou yu sheng
虎口拔牙	hu kou ba ya
虎口逃生	hu kou tao sheng
虎头虎脑	hu tou hu nao
虎头蛇尾	hu tou she wei
虎背熊腰	hu bei xiong yao
虎落平阳	hu luo ping yang
虎视眈眈	hu shi dan dan
虎踞龙盘	hu ju long pan
虚与委蛇	xu yu wei yi
虚位以待	xu wei yi dai
虚度光阴	xu du guang yin
虚度年华	xu du nian hua
虚张声势	xu zhang sheng shi
虚怀若谷	xu huai ruo gu
虚情假意	xu qing jia yi
虚惊一场	xu jing yi chang
虚掷光阴	xu zhi guang yin
虚无缥缈	xu wu piao miao
虚晃一枪	xiu huang yi qiang
虚有其表	xu you qi biao
虚虚实实	xu xu shi shi
虽死犹生	sui si you sheng
虽死犹荣	sui si you rong
虾兵蟹将	xia bing xie jiang
蚍蜉撼树	pi fu han shu
蚕食鲸吞	can shi jing tun
蛇蝎心肠	she xie xin chang
蛊惑人心	gu huo ren xin
蛛丝马迹	zhu si ma ji
蛮不讲理	man bu jiang li
蛮横无理	man heng wu li
蜂拥而上	feng yong er shang
蜂拥而来	feng yong er lai
蜂拥而至	feng yong er zhi
蜂拥而起	feng yong er qi
蜕化变质	tui hua bian zhi
蜜里藏刀	mi li cang dao
蜻蜓点水	qing ting dian shui
蝇头小利	ying tou xiao li
蝇营狗苟	ying ying gou gou
融为一体	rong wei yi ti
融会贯通	rong hui guan tong
融汇贯通	rong hui guan tong
螳臂当车	tang bi dang che
螳臂挡车	tang bi dang che
螳螂捕蝉	tang lang bu chan
蠢蠢欲动	chun chun yu dong
血债累累	xue zhai lei lei
血口喷人	xue kou pen ren
血战到底	xue zhan dao di
血气方刚	xue qi fang gang
血流如注	xue liu ru zhu
血流成河	xue liu cheng he
血海深仇	xue hai shen chou
血盆大口	xue pen da kou
血肉模糊	xue rou mo hu
血肉横飞	xue rou heng fei
血肉相连	xue rou xiang lian
血迹斑斑	xue ji ban ban
血雨腥风	xue yu xing feng
行之有效	xing zhi you xiao
行云流水	xing yun liu shui
行家里手	hang jia li shou
行将就木	xing jiang jiu mu
行尸走肉	xing shi zou rou
行色匆匆	xing se cong cong
行若无事	xing ruo wu shi
行走如飞	xing bu ru fei
行迹可疑	xing ji ke yi
街坊四邻	jie fang si lin
街坊邻居	jie fang lin ju
街坊邻里	jie fang lin li
街头巷尾	jie tou xiang wei
街谈巷议	jie tan xiang yi
衣不蔽体	yi bu bi ti
衣冠楚楚	yi guan chu chu
衣冠禽兽	yi guan qin shou
衣衫褴褛	yi shan lan lu
衣锦还乡	yi jin huan xiang
衣食住行	yi shi zhu xing
衣食父母	yi shi fu mu
表里一致	biao li yi zhi
表里不一	biao li bu yi
表里如一	biao li ru yi
表面文章	biao mian wen zhang
袒胸露背	tan xiong lu bei
袖手旁观	xiu shou pang guan
装傻充愣	zhuang sha chong leng
装模作样	zhuang mo zuo yang
装模做样	zhuang mo zuo yang
装点门面	zhuang dian men mian
装疯作傻	zhuang feng zuo sha
装疯卖傻	zhuang feng mai sha
装痴卖傻	zhuang chi mai sha
装神弄鬼	zhuang shen nong gui
装聋作哑	zhuang long zuo ya
装聋做哑	zhuang long zuo ya
装腔作势	zhuang qiang zuo shi
装腔作态	zhuang qiang zuo tai
装腔做势	zhuang qiang zuo shi
裙带关系	qun dai guan xi
裹足不前	guo zu bu qian
西装革履	xi zhuang ge lu
要价还价	yao jia huan jia
要死不活	yao si bu huo
要死要活	yao si yao huo
覆水难收	fu shui nan shou
见义勇为	jian yi yong wei
见仁见智	jian ren jian zhi
见利忘义	jian li wang yi
见势不妙	jian shi bu miao
见多识广	jian duo shi guang
见好就收	jian hao jiu shou
见异思迁	jian yi si qian
见微知著	jian wei zhi zhu
见怪不怪	jian guai bu guai
见所未见	jian suo wei jian
见智见仁	jian zhi jian ren
见机而行	jian ji er xing
见机行事	jian ji xing shi
见死不救	jian si bu jiu
见缝插针	jian feng cha zhen
见财起意	jian cai qi yi
见贤思齐	jian xian si qi
见钱眼开	jian qian yan kai
见钱眼红	jian qian yan hong
见风使舵	jian feng shi duo
见风是雨	jian feng shi yu
见风转舵	jian feng zhuan duo
观望不前	guan wang bu qian
规规矩矩	gui gui ju ju
视为儿戏	shi wei er xi
视为知己	shi wei zhi ji
视为至宝	shi wei zhi bao
视同儿戏	shi tong er xi
视同手足	shi tong shou zu
视同陌路	shi tong mo lu
视如珍宝	shi ru zhen bao
视如草芥	shi ru cao jie
视死如归	shi si ru gui
视而不见	shi er bu jian
视若儿戏	shi ruo er xi
视若无睹	shi ruo wu du
视财如命	shi cai ru ming
解囊相助	jie nang xiang zhu
解放思想	jie fang si xiang
解甲归田	jie jia gui tian
觥筹交错	gong chou jiao cuo
触手可及	chu shou ke ji
触景伤情	chu jing shang qing
触景生情	chu jing sheng qing
触目惊心	chu mu jing xin
触目皆是	chu mu jie shi
触类旁通	chu lei pang tong
言不尽意	yan bu jin yi
言不由衷	yan bu you zhong
言为心声	yan wei xin sheng
言之凿凿	yan zhi zao zao
言之成理	yan zhi cheng li
言之无物	yan zhi wu wu
言之有序	yan zhi you xu
言之有物	yan zhi you wu
言之有理	yan zhi you li
言传身教	yan chuan shen jiao
言听计从	yan ting ji cong
言外之意	yan wai zhi yi
言多必失	yan duo bi shi
言多语失	yan duo yu shi
言归于好	yan gui yu hao
言归正传	yan gui zheng zhuan
言无不尽	yan wu bu jin
言犹在耳	yan you zai er
言简意深	yan jian yi shen
言简意赅	yan jian yi gai
言而无信	yan er wu xin
言而有信	yan er you xin
言行一致	yan xing yi zhi
言行不一	yan xing bu yi
言行不符	yan xing bu fu
言行相悖	yan xing xiang bei
言行相符	yan xing xiang fu
言谈举止	yan tan ju zhi
言过其实	yan guo qi shi
誉满全球	yu man quan qiu
誉满天下	yu man tian xia
誓不两立	shi bu liang li
誓不罢休	shi bu ba xiu
誓死不二	shi si bu er
誓死不从	shi si bu cong
誓死不屈	shi si bu qu
誓死不渝	shi si bu yu
计上心头	ji shang xin tou
计上心来	ji shang xin lai
认祖归宗	ren zu gui zong
认贼作父	ren zei zuo fu
讨价还价	tao jia huan jia
训练有素	xun lian you su
议事日程	yi shi ri cheng
议论纷纭	yi lun fen yun
议论纷纷	yi lun fen fen
记忆犹新	ji yi you xin
讳疾忌医	hui ji ji yi
讳莫如深	hui mo ru shen
许许多多	xu xu duo duo
论功行赏	lun gong xing shang
论资排辈	lun zi pai bei
设下圈套	she xia quan tao
设身处地	she shen chu di
证据确凿	zheng ju que zao
评头品足	ping tou pin zu
评头论足	ping tou lun zu
诉诸武力	su zhu wu li
词不达意	ci bu da yi
诗情画意	shi qing hua yi
诚心实意	cheng xin shi yi
诚心诚意	cheng xin cheng yi
诚惶诚恐	cheng huang cheng kong
话不投机	hua bu tou ji
话中带刺	hua zhong dai ci
话中有话	hua zhong you hua
话里带刺	hua li dai ci
话里有刺	hua li you ci
话里有话	hua li you hua
诡秘莫测	gui mi mo ce
诡计多端	gui ji duo duan
详略得当	xiang lue de dang
语惊四座	yu jing si zuo
语无伦次	yu wu lun ci
语焉不详	yu yan bu xiang
语简意赅	yu jian yi gai
语重心长	yu zhong xin chang
误人子弟	wu ren zi di
误入歧途	wu ru qi tu
误国殃民	wu guo yang min
误打误撞	wu da wu zhuang
诱敌深入	you di shen ru
诲人不倦	hui ren bu juan
说一不二	shuo yi bu er
说三道四	shuo san dao si
说不过去	shuo bu guo qu
说东道西	shuo dong dao xi
说到做到	shuo dao zuo dao
说来话长	shuo lai hua chang
说来说去	shuo lai shuo qu
说说笑笑	shuo shuo xiao xiao
说长论短	shuo chang lun duan
说长道短	shuo chang dao duan
说风凉话	shuo feng liang hua
请君入瓮	qing jung ru weng
请客送礼	qing ke song li
诸如此类	zhu ru ci lei
谁是谁非	shui shi shui fei
调兵遣将	diao bing qian jiang
调虎离山	diao hu li shan
谄上欺下	chan shang qi xia
谆谆告诫	zhun zhun gao jie
谆谆教导	zhun zhun jiao dao
谆谆教诲	zhun zhun jiao hui
谈何容易	tan he rong yi
谈古论今	tan gu lun jin
谈天论地	tan tian lun di
谈天说地	tan tian shuo di
谈情说爱	tan qing shuo ai
谈笑自如	tan xiao zi ru
谈笑自若	tan xiao zi ruo
谈笑风生	tan xiao feng sheng
谈虎色变	tan hu se bian
谋事在人	mou shi zai ren
谋财害命	mou cai hai ming
谢天谢地	xie tian xie di
谦虚谨慎	qian xu jin shen
谦谦君子	qian qian jun zi
谨小慎微	jin xiao shen wei
谨慎从事	jin shen cong shi
谨慎小心	jin shen xiao xin
谨言慎行	jin yan shen xing
谬以千里	miu yi qian li
谬误百出	miu wu bai chu
豁然开朗	huo ran kai lang
豁然省悟	huo ran xing wu
豁然贯通	huo ran guan tong
豁达大度	huo da da du
豆蔻年华	dou kou nian hua
豪情壮志	hao qing zhuang zhi
豪放不羁	hao fang bu ji
豪言壮语	hao yan zhuang yu
豺狼当道	chai lang dang dao
豺狼成性	chai lang cheng xing
豺狼虎豹	chai lang hu bao
貌不惊人	mao bu jing ren
貌合神离	mao he shen li
负债累累	fu zhai lei lei
负荆请罪	fu jing qing zui
负荆谢罪	fu jing xie zui
负隅顽抗	fu yu wan kang
财大气粗	cai da qi cu
财运亨通	cai yun heng tong
财迷心窍	cai mi xin qiao
责无旁贷	ze wu pang dai
贤妻良母	xian qi liang mu
败兴而归	bai xing er gui
败军之将	bai jun zhi jiang
货真价实	huo zhen jia shi
质朴无华	zhi pu wu a
贪利忘义	tan li wang yi
贪图安逸	tan tu an yi
贪官污吏	tan guan wu li
贪小失大	tan xiao shi da
贪得无厌	tan de wu yan
贪心不足	tan xin bu zu
贪求无厌	tan qiu wu yan
贪污受贿	tan wu shou hui
贪污腐化	tan wu fu hua
贪生怕死	tan sheng pa si
贪生畏死	tan sheng wei si
贪财好色	tan cai hao se
贪赃枉法	tan zang wang fa
贪赃纳贿	tan zang na hui
贫困潦倒	pin kun liao dao
贫富不均	pin fu bu jun
贫富悬殊	pin fu xuan shu
贫病交加	pin bing jiao jia
贫穷潦倒	pin qiong liao dao
贫贱不移	pin jian bu yi
贫贱之交	pin jian zhi jiao
贯彻始终	guan che shi zhong
费尽心思	fei jin xin si
费尽心机	fei jin xin ji
贻害无穷	yi hai wu qiong
贻患无穷	yi huan wu qiong
贻笑大方	yi xiao da fang
贼喊捉贼	zei han zhuo zei
贼头贼脑	zei tou zei nao
贼心不死	zei xin bu si
贼眉鼠眼	zei mei shu yan
赌咒发誓	du zhou fa shi
赏心悦目	shang xin yue mu
赏罚不当	shang fa bu dang
赏罚不明	shang fa bu ming
赏罚严明	shang fa yan ming
赏罚分明	shang fa fen ming
赔本买卖	pei ben mai mai
赞不绝口	zan bu jue kou
赞叹不已	zan tan bu yi
赤子之心	chi zi zhi xin
赤手空拳	chi shou kong quan
赤胆忠心	chi dan zhong xin
赤膊上阵	chi bo shang zhen
赤诚相待	chi cheng xiang dai
赤身裸体	chi shen luo ti
赤身露体	chi shen lu ti
赫赫有名	he he you ming
走下坡路	zou xia po lu
走为上策	zou wei shang ce
走为上计	zou wei shang ji
走南闯北	zou nan chuang bei
走回头路	zou hui tou lu
走投无路	zou tou wu lu
走漏风声	zou lou feng sheng
走火入魔	zou huo ru mo
走街串巷	zou jie chuan xiang
走马上任	zou ma shang ren
走马看花	zou ma kan hua
走马观花	zou ma guan hua
赴汤蹈火	fu tang dao huo
赶尽杀绝	gan jin sha jue
起承转合	qi cheng zhuan he
起早摸黑	qi zao mo hei
起早贪黑	qi zao tan hei
起死回生	qi si hui sheng
趁人之危	chen ren zhi wei
趁火打劫	chen huo da jie
趁热打铁	chen re da tie
趁虚而入	chen xu er ru
超乎寻常	chao hu xun chang
超凡脱俗	chao fan tuo su
超然物外	chao ran wu wai
超群出众	chao qun chu zhong
超群绝伦	chao qun jue lun
越俎代庖	yue zu dai pao
趋之如鹜	qu zhi ru wu
趋之若鹜	qu zhi ruo wu
趋利避害	qu li bi hai
趋吉避凶	qu ji bi xiong
趋炎附势	qu yan fu shi
足不出户	zu bu chu hu
足智多谋	zu zhi duo mou
趾高气扬	zhi gao qi yang
跃然纸上	yue ran zhi shang
跃跃欲试	yue yue yu shi
跋山涉水	ba shan she shui
跌打损伤	die da sun shang
跌跌撞撞	die die zhuang zhuang
路不拾遗	lu bu shi yi
路人皆知	lu ren jie zhi
路见不平	lu jian bu ping
跳梁小丑	tiao liang xiao chou
踉踉跄跄	liang liang qiang qiang
踌躇不决	chou chu bu jue
踌躇不前	chou chu bu qian
踌躇不定	chou chu bu ding
踌躇满志	chou chu man zhi
踏踏实实	ta ta shi shi
踟蹰不前	chi chu bu qian
蹉跎岁月	cuo tuo sui yue
蹑手蹑脚	nie shou nie jiao
蹦蹦跳跳	beng beng tiao tiao
身不由主	shen bu you zhu
身不由己	shen bu you ji
身临其境	shen lin qi jing
身价倍增	shen jia bei zeng
身价百倍	shen jia bai bei
身体力行	shen ti li xing
身先士卒	shen xian shi zu
身历其境	shen li qi jing
身外之物	shen wai zhi wu
身家性命	shen jia xing mingv
身强力壮	shen qiang li zhuang
身心交瘁	shen xin jiao cui
身心健康	shen xin jian kang
身怀六甲	shen huai liu jia
身无分文	shen wu fen wen
身无完肤	shen wu wan fu
身无长物	shen wu zhang wu
身经百战	shen jing bai zhan
身败名裂	shen bai ming lie
身首异处	shen shou yi chu
躲躲藏藏	duo duo cang cang
躲躲闪闪	duo duo shan shan
车水马龙	che shui ma long
车载斗量	che zai dou liang
轩然大波	xuan ran da bo
转危为安	zhuan wei wei an
转弯抹角	zhuan wan mo jiao
转忧为喜	zhuan you wei xi
转悲为喜	zhuan bei wei xi
转眼之间	zhuan yan zhi jian
转瞬之间	zhuan shun zhi jian
转败为胜	zhuan bai wei sheng
软弱无力	ruan ruo wu li
软弱无能	ruan ruo wu neng
软硬不吃	ruan ying bu chi
软硬兼施	ruan ying jian shi
轰动一时	hong dong yi shi
轰轰烈烈	hong hong lie lie
轻举妄动	qing ju wang dong
轻于鸿毛	qing yu hong mao
轻如鸿毛	qing ru hong mao
轻手蹑脚	qing shou nie jiao
轻手轻脚	qing shou qing jiao
轻描淡写	qing miao dan xie
轻松愉快	qing song yu kuai
轻歌曼舞	qing ge man wu
轻而易举	qing er yi ju
轻若鸿毛	qing ruo hong mao
轻装上阵	qing zhuang shang zhen
轻言细语	qing yan xi yu
轻车熟路	qing che shu lu
轻重倒置	qing zhong dao zhi
轻重缓急	qing zhong huan ji
载歌载舞	zai ge zai wu
载誉而归	zai yu er gui
辉煌夺目	hui huang duo mu
辗转反侧	zhan zhuan fan ce
辛辛苦苦	xin xin ku ku
辞不达意	ci bu da yi
辞严义正	ci yan yi zheng
辞简意赅	ci jian yi gai
达官贵人	da guan gui ren
迁怒于人	qian nu yu ren
迂回曲折	yu hui qu zhe
过关斩将	guo guan zhan jiang
过意不去	guo yi bu qu
过河拆桥	guo he chai qiao
过犹不及	guo you bu ji
过目不忘	guo mu bu wang
过眼云烟	guo yan yun yan
过眼烟云	guo yan yan yun
过街老鼠	guo jie lao shu
迎刃而解	ying ren er jie
迎头痛击	ying tou tong ji
迎头赶上	ying tou gan shang
迎来送往	ying lai song wang
迎风招展	ying feng zhao zhan
运用自如	yun yong zi ru
运筹帷幄	yun chou wei wo
近乡情怯	jin xiang qing qie
近亲繁殖	jin qin fan zhi
近在咫尺	jin zai zhi chi
近在眉睫	jin zai mei jie
近墨者黑	jin mo zhe hei
近朱者赤	jin zhu zhe chi
近水楼台	jin shui lou tai
返朴归真	fan pu gui zhen
返璞归真	fan pu gui zhen
返老还童	fan lao huan tong
进进出出	jin jin chu chu
进退两难	jin tui liang nan
进退失据	jin tui shi ju
进退无路	jin tui wu lu
进退维谷	jin tui wei gu
远交近攻	yuan jiao jin gong
远涉重洋	yuan she chong yang
远见卓识	yuan jian zhuo shi
远走高飞	yuan zou gao fei
远近闻名	yuan jin wen ming
远近驰名	yuan jin chi ming
违心之言	wei xin zhi yan
违法乱纪	wei fa luan ji
连滚带爬	lian gun dai pa
连篇累牍	lian pian lei du
连绵不断	lian mian bu duan
连绵不绝	lian mian bu jue
连绵起伏	lian mian qi fu
连蒙带骗	lian meng dai pian
连蹦带跳	lian beng dai tiao
连锁反应	lian suo fan ying
迟疑不决	chi yi bu jue
迟疑不定	chi yi bu ding
迥然不同	jiong ran bu tong
迫不及待	po bu ji dai
迫不得已	po bu de yi
迫在眉睫	po zai mei jie
迷惑不解	mi huo bu jie
迷迷糊糊	mi mi hu hu
迷途知返	mi tu zhi fan
追名逐利	zhui ming zhu li
追悔无及	zhui hui wu ji
追悔莫及	zhui hui mo ji
追本求源	zhui ben qiu yuan
追本溯源	zhui ben su yuan
追根寻底	zhui gen xun di
追根求源	zhui gen qiu yuan
追根溯源	zhui gen su yuan
追根究底	zhui gen jiu di
追根究蒂	zhui gen jiu di
追根问底	zhui gen wen di
退避三舍	tui bi san she
送往迎来	song wang ying lai
送旧迎新	song jiu ying xin
送货上门	song huo shang men
适可而止	shi ke er zhi
适得其反	shi de qi fan
适者生存	shi zhe sheng cun
逃之夭夭	tao zhi yao yao
逃避现实	tao bi xian shi
逆来顺受	ni lai shun shou
逆水行舟	ni shui xing zhou
逆流而上	ni liu er shang
逆耳之言	ni er zhi yan
逆耳忠言	ni er zhong yan
逆耳良言	ni er liang yan
选贤任能	xuan xian ren neng
逍遥法外	xiao yao fa wai
逍遥自在	xiao yao zi zai
逍遥自得	xiao yao zi de
逐字逐句	zhu zi zhu ju
通俗易懂	tong su yi dong
通力合作	tong li he zuo
通宵达旦	tong xiao da dan
通情达理	tong qing da li
通行无阻	tong xing wu zu
通风报信	tong feng bao xin
逞强好胜	cheng qiang hao sheng
速战速决	su zhan su jue
造化弄人	zao hua nong ren
造谣中伤	zao yao zhong shang
造谣惑众	zao yao huo zhong
造谣生事	zao yao sheng shi
逢凶化吉	feng xiong hua ji
逢场作戏	feng chang zuo xi
逢山开路	feng shan kai lu
逢年过节	feng nian guo jie
逼上梁山	bi shang liang shan
逼不得已	bi bu de yi
逼人太甚	bi ren tai shen
遇人不淑	yu ren bu shu
遍体鳞伤	bian ti lin shang
遍地开花	bian di kai hua
道不拾遗	dao bu shi yi
道听涂说	dao ting tu shuo
道听途说	dao ting tu shuo
道貌凛然	dao mao lin ran
道貌岸然	dao mao an ran
遗世独立	yi shi du li
遗害无穷	yi hai wu qiong
遗患无穷	yi huan wu qiong
遗祸无穷	yi huo wu qiong
遗臭万年	yi chou wan nian
遣词造句	qian ci zao ju
遥相呼应	yao xiang hu ying
遥遥在望	yao yao zai wang
遥遥无期	yao yao wu qi
遥遥相对	yao yao xiang dui
遥遥相望	yao yao xiang wang
遥遥领先	yao yao ling xian
遮人耳目	zhe ren er mu
遮天盖地	zhe tian gai di
遮天蔽日	zhe tian bi ri
遮遮掩掩	zhe zhe yan yan
遮风挡雨	zhe feng dang yu
避实就虚	bi shi jiu xu
避繁就简	bi fan jiu jian
避而不谈	bi er bu tan
避重就轻	bi zhong jiu qing
邀功请赏	yao gong qing shang
邂逅相遇	xie hou xiang yu
邋邋遢遢	la la ta ta
邪不压正	xie bu ya zheng
邪不胜正	xie bu sheng zheng
邪门歪道	xie men wai dao
邪魔外道	xie mo wai dao
邪魔歪道	xie mo wai dao
邯郸学步	han dan xue bu
郁郁不乐	yu yu bu le
郁郁寡欢	yu yu gua huan
郁郁葱葱	yu yu cong cong
郎才女貌	lang cai nu mao
郑重其事	zheng zhong qi shi
鄙夷不屑	bi yi bu xie
酒后失言	jiu hou shi yan
酒囊饭袋	jiu nang fan dai
酒池肉林	jiu chi rou lin
酒肉朋友	jiu rou peng you
酒色之徒	jiu se zhi tu
酒色财气	jiu se cai qi
酒足饭饱	jiu zu fan bao
酗酒滋事	xu jiu zi shi
酣畅淋漓	han chang lin li
酩酊大醉	ming ding da zui
酸甜苦辣	suan tian ku la
醉生梦死	zui sheng meng si
醉翁之意	zui weng zhi yi
醍醐灌顶	ti hu guan ding
里应外合	li ying wai he
里通外国	li tong wai guo
里里外外	li li wai wai
重于泰山	zhong yu tai shan
重修旧好	chong xiu jiu hao
重山峻岭	chong shan jun ling
重峦叠嶂	chong luan die zhang
重弹老调	chong tan lao diao
重归于好	chong gui yu hao
重振旗鼓	chong zhen qi gu
重提旧事	chong ti jiu shi
重操旧业	chong cao jiu ye
重整旗鼓	chong zheng qi gu
重新做人	chong xin zuo ren
重温旧梦	chong wen jiu meng
重男轻女	zhong nan qing nu
重色轻友	zhong se qing you
重见天日	chong jian tian ri
重蹈覆辙	chong dao fu zhe
野心勃勃	ye xin bo bo
量体裁衣	liang ti cai yi
量入为出	liang ru wei chu
量力而为	liang li er wei
量力而行	liang li er xing
量才录用	liang cai lu yong
金光灿烂	jin guang can lan
金光闪闪	jin guang shan shan
金口玉言	jin kou yu yan
金字招牌	jin zi zhao pai
金屋藏娇	jin wu cang jiao
金戈铁马	jin ge tie ma
金无足赤	jin wu zu chi
金枝玉叶	jin zhi yu ye
金榜题名	jin bang ti ming
金玉满堂	jin yu man tang
金玉良言	jin yu liang yan
金盆洗手	jin pen xi shou
金石良言	jin shi liang yan
金碧辉煌	jin bi hui huang
金科玉律	jin ke yu lu
金童玉女	jin tong yu nu
金蝉脱壳	jin chan tuo qiao
金鸡独立	jin ji du li
釜底抽薪	fu di chou xin
鉴往知来	jian wang zhi lai
针锋相对	zhen feng xiang dui
钦差大臣	qin chai da chen
钩心斗角	gou xin dou jiao
钻牛角尖	zuan niu jiao jian
铁壁铜墙	tie bi tong qiang
铁杵成针	tie chu cheng zhen
铁杵磨针	tie chu mo zhen
铁板一块	tie ban yi kuai
铁板钉钉	tie ban ding ding
铁树开花	tie shu kai hua
铁案如山	tie an ru shan
铁石心肠	tie shi xin chang
铁腕人物	tie wan ren wu
铁证如山	tie zheng ru shan
铁面无私	tie mian wu si
铁骨铮铮	tie gu zheng zheng
铜墙铁壁	tong qiang tie bi
铜筋铁骨	tong jin tie gu
铢积寸累	zhu ji cun lei
铤而走险	ting er zou xian
铩羽而归	sha yu er gui
铭心刻骨	ming xin ke gu
铮铮铁骨	zheng zheng tie gu
铲草除根	chan cao chu gen
银装素裹	yin zhuanɡ su ɡuo
铸成大错	zhu cheng da cuo
铺天盖地	pu tian gai di
铺张浪费	pu zhang lang fei
铿锵有力	keng qiang you li
销声匿迹	xiao sheng ni ji
锄强扶弱	chu qiang fu ruo
锋芒所向	feng mang suo xiang
锋芒毕露	feng mang bi lu
锋芒逼人	feng mang bi ren
锐不可当	rui bu ke dang
锒铛入狱	lang kang ru yu
错上加错	cuo shang jia cuo
错综复杂	cuo zong fu za
错落有致	cuo luo you zhi
错过时机	cuo guo shi ji
锣鼓喧天	luo gu xuan tian
锦上添花	jin shang tian hua
锦囊妙计	jin nang miao ji
锦绣前程	jin xiu qian cheng
锦绣山河	jin xiu shan he
锦绣河山	jin xiu he shan
锦衣玉食	jin yi yu shi
锱铢必较	zi zhu bi jiao
锲而不舍	qie er bu she
镇定自若	zhen ding zi ruo
镜花水月	jing hua shui yue
长久之计	chang jiu zhi ji
长吁短叹	chang xu duan tan
长命百岁	chang ming bai sui
长夜漫漫	chang ye man man
长年累月	chang nian lei yue
长幼有序	zhang you you xu
长此以往	chang ci yi wang
长治久安	chang zhi jiu an
长生不老	chang sheng bu lao
长篇大论	chang pian da lun
长篇累牍	chang pian lei du
长袖善舞	chang xiu shan wu
长话短说	chang hua duan shuo
长途跋涉	chang tu ba she
长驱直入	chang qu zhi ru
门可罗雀	men ke luo que
门庭若市	men ting ruo shi
门当户对	men dang hu dui
门户之争	men hu zhi zheng
门户开放	men hu kai fang
闪亮登场	shan liang deng chang
闪烁其词	shan shuo qi ci
闪烁其辞	shan shuo qi ci
闭关自守	bi guan zi shou
闭关锁国	bi guan suo guo
闭口不言	bi kou bu yan
闭口不谈	bi kou bu tan
闭口无言	bi kou wu yan
闭月羞花	bi yue xiu hua
闭目塞听	bi mu se ting
闭门不出	bi men bu chu
闭门思过	bi men si guo
闭门谢客	bi men xie ke
闭门造车	bi men zao che
问寒问暖	wen han wen nuan
问心无愧	wen xin wu kui
问心有愧	wen xin you kui
问长问短	wen chang wen duan
闯荡江湖	chuang dang jiang hu
闲云野鹤	xian yun ye he
闲情逸致	xian qing yi zhi
闲杂人等	xian za ren deng
闲言碎语	xian yan sui yu
闲言闲语	xian yan xian yu
间不容缓	jian bu rong huan
闷声不响	men sheng bu xiang
闷闷不乐	men men bu le
闹中取静	nao zhong qu jing
闻一知十	wen yi zhi shi
闻名遐迩	wen ming xia er
闻所未闻	wen suo wei wen
闻过则喜	wen guo ze xi
闻风丧胆	wen feng sang dan
闻风而动	wen feng er dong
闻风而至	wen feng er zhi
闻风而起	wen feng er qi
闻风而逃	wen feng er tao
闻鸡起舞	wen ji qi wu
防不胜防	fang bu sheng fang
防微杜渐	fang wei du jian
防患未然	fang huan wei ran
阳关大道	yang guan da dao
阳奉阴违	yang feng yin wei
阳春白雪	yang chun bai xue
阴云密布	yin yun mi bu
阴差阳错	yin cha yang cuo
阴谋诡计	yin mou gui ji
阴错阳差	yin cuo yang cha
阴阳怪气	yin yang guai qi
阴霾密布	yin mai mi bu
阴魂不散	yin hun bu san
阿猫阿狗	a mao a gou
阿谀奉承	e yu feng cheng
阿谀逢迎	e yu feng ying
附庸风雅	fu yong feng ya
陆陆续续	lu lu xu xu
陈旧不堪	chen jiu bu kan
陈规陋习	chen gui lou xi
陈词滥调	chen ci lan diao
陈辞滥调	chen ci lan diao
降龙伏虎	xiang long fu hu
除恶务尽	chu e wu jin
除旧布新	chu jiu bu xin
除旧更新	chu jiu geng xin
除暴安良	chu bao an liang
险象环生	xian xiang huan sheng
陷入僵局	xian ru jiang ju
随声附和	sui sheng fu he
随心所欲	sui xin suo yu
随手拈来	sui shou nian lai
随时随地	sui shi sui di
随机应变	sui ji ying bian
随波逐流	sui bo zhu liu
随行就市	sui hang jiu shi
随遇而安	sui yu er an
随随便便	sui sui bian bian
隐姓埋名	yin xing mai ming
隐忍不发	yin ren bu fa
隐恶扬善	yin e yang shan
隐约其辞	yin yue qi ci
隐隐约约	yin yin yue yue
隔三差五	ge san cha wu
隔墙有耳	ge qiang you er
隔岸观火	ge an guan huo
隔靴搔痒	ge xue sao yang
难上加难	nan shang jia nan
难于启齿	nan yi qi chi
难以为情	nan yi wei qing
难以为继	nan yi wei ji
难以启齿	nan yi qi chi
难以忘怀	nan yi wang huai
难以挽回	nan yi wan hui
难以理喻	nan yi li yu
难以置信	nan yi zhi xin
难以预料	nan yi yu liao
难兄难弟	nan xiong nan di
难分难舍	nan fen nan she
难分难解	nan fen nan jie
难割难分	nan ge nan fen
难割难舍	nan ge nan she
难如登天	nan ru deng tian
难得糊涂	nan de hu tu
难能可贵	nan neng ke gui
难舍难分	nan she nan fen
难舍难离	nan she nan li
难解难分	nan jie nan fen
难言之隐	nan yan zhi yin
雀跃欢呼	que yue huan hu
雁过拔毛	yan guo ba mao
雄伟壮观	xiong wei zhuang guan
雄心勃勃	xiong xin bo bo
雄心壮志	xiong xin zhuang zhi
雄才大略	xiong cai da lue
雅俗共赏	ya su gong shang
集思广益	ji si guang yi
集腋成裘	ji ye cheng qiu
雍容典雅	yong rong dian ya
雍容华贵	yong rong hua gui
雍容大度	yong rong da du
雕栏玉砌	diao lan yu qi
雕梁画栋	diao liang hua dong
雕虫小技	diao chong xiao ji
雨后春笋	yu hou chun sun
雨淋日晒	yu lin ri shai
雨过天晴	yu guo tian qing
雪上加霜	xue shang jia shuang
雪中送炭	xue zhong song tan
零七八碎	ling qi ba sui
零敲碎打	ling qiao sui da
零零散散	ling ling san san
零零星星	ling ling xing xing
零零碎碎	ling ling sui sui
雷厉风行	lei li feng xing
雷大雨小	lei da yu xiao
雷打不动	lei da bu dong
雷电交加	lei dian jiao jia
雷霆万钧	lei ting wan jun
雾里看花	wu li kan hua
震天动地	zhen tian dong di
震慑人心	zhen she ren xin
震撼人心	zhen han ren xin
震耳欲聋	zhen er yu long
霞光万道	xia guang wan dao
露出马脚	lou chu ma jiao
霸王别姬	ba wang bie ji
霸道横行	ba dao heng xing
青云直上	qing yun zhi shang
青出于蓝	qing chu yu lan
青史留名	qing shi liu ming
青天白日	qing tian bai ri
青山绿水	qing shan lu shui
青梅竹马	qing mei zhu ma
青红皂白	qing hong zao bai
青面獠牙	qing mian liao ya
青黄不接	qing huang bu jie
非亲非故	fei qin fei gu
非分之想	fei fen zhi xiang
非同寻常	fei tong xun chang
非同小可	fei tong xiao ke
非我族类	fei wo zu lei
非我莫属	fei wo mo shu
非此即彼	fei ci ji bi
非驴非马	fei lu fei ma
靠天吃饭	kao tian chi fan
靡靡之音	mi mi zhi yin
面不改色	mian bu gai se
面如土色	mian ru tu se
面无人色	mian wu ren se
面有难色	mian you nan se
面目一新	mian mu yi xin
面目全非	mian mu quan fei
面目可憎	mian mu ke zeng
面目狰狞	mian mu zheng ning
面红耳赤	mian hong er chi
面貌一新	mian mao yi xin
面貌狰狞	mian mao zheng ning
面面俱到	mian mian ju dao
面面相觑	mian mian xiang qu
面黄肌瘦	mian huang ji shou
革故鼎新	ge gu ding xin
鞍前马后	an qian ma hou
鞠躬尽瘁	ju gong jin cui
鞭辟入里	bian pi ru li
鞭长莫及	bian chang mo ji
韬光养晦	tao guang yang hui
音容笑貌	yin rong xiao mao
顶天立地	ding tian li di
顶头上司	ding tou shang si
顶礼膜拜	ding li mo bai
顷刻之间	qing ke zhi jian
项庄舞剑	xiang zhuang wu jian
顺手牵羊	shun shou qian yang
顺水人情	shun shui ren qing
顺水推舟	shun shui tui zhou
顺水推船	shun shui tui chuan
顺水行舟	shun shui xing zhou
顺流而下	shun liu er xia
顺理成章	shun li cheng zhang
顺蔓摸瓜	shun man mo gua
顺藤摸瓜	shun teng mo gua
顺顺利利	shun shun li li
顺顺当当	shun shun dang dang
顺风使舵	shun feng shi duo
顺风转舵	shun feng zhuan duo
须发皆白	xu fa jie bai
顽固不化	wan gu bu hua
顾全大局	gu quan da ju
顾名思义	gu ming si yi
顾客盈门	gu ke ying men
顾影自怜	gu ying zi lian
顾此失彼	gu ci shi bi
顾盼生辉	gu pan sheng hui
顾虑重重	gu lu chong chong
顿开茅塞	dun kai mao se
顿足捶胸	dun zu chui xiong
颐养天年	yi yang tian nian
颐指气使	yi zhi qi shi
颗粒无收	ke li wu shou
颜面扫地	yan mian sao di
颠三倒四	dian san dao si
颠倒是非	dian dao shi fei
颠倒黑白	dian dao hei bai
颠扑不破	dian pu bu po
颠来倒去	dian lai dao qu
颠沛流离	dian pei liu li
颤颤巍巍	chan chan wei wei
风云人物	feng yun ren wu
风云变幻	feng yun bia huan
风云变色	feng yun bia se
风云突变	feng yun tu bian
风云际会	feng yun ji hui
风俗习惯	feng su xi guan
风俗人情	feng su ren qing
风华正茂	feng hua zheng mao
风华绝代	feng hua jue dai
风卷残云	feng juan can yun
风口浪尖	feng kou lang jian
风吹日晒	feng chui ri shai
风吹浪打	feng chui lang da
风吹草动	feng chui cao dong
风吹雨打	feng chui yu da
风和日丽	feng he ri li
风土人情	feng tu ren qing
风声鹤唳	feng sheng he li
风姿绰约	feng zi chuo yue
风尘仆仆	feng chen pu pu
风平浪静	feng ping lang jing
风度翩翩	feng du pian pian
风流人物	feng liu ren wu
风流倜傥	feng liu ti tang
风流才子	feng liu cai zi
风流潇洒	feng liu xiao sa
风流韵事	feng liu yun shi
风烛残年	feng zhu can nian
风花雪月	feng hua xue yue
风行一时	feng xing yi shi
风言风语	feng yan feng yu
风调雨顺	feng tiao yu shun
风起云涌	feng qi yun yong
风轻云淡	feng qing yun dan
风雨交加	feng yu jiao jia
风雨同舟	feng yu tong zhou
风雨无阻	feng yu wu zu
风雨飘摇	feng yu piao yao
风雪交加	feng xue jiao jia
风霜雨雪	feng shuang yu xue
风靡一时	feng mi yi shi
风韵犹存	feng yun you cun
风风火火	feng feng huo huo
风风雨雨	feng feng yu yu
风餐露宿	feng can lu su
风驰电掣	feng chi dian che
飒爽英姿	sa shuang ying zi
飘洋过海	piao yang guo hai
飘飘欲仙	piao piao yu xian
飞扬跋扈	fei yang ba hu
飞来横祸	fei lai heng huo
飞檐走壁	fei yan zou bi
飞沙走石	fei sha zou shi
飞砂走石	fei sha zou shi
飞禽走兽	fei qin zou shou
飞蛾扑火	fei e pu huo
飞蛾投火	fei e tou huo
飞黄腾达	fei huang teng da
食不果腹	shi bu guo fu
食不甘味	shi bu gan wei
食古不化	shi gu bu hua
饥不择食	ji bu ze shi
饥寒交迫	ji han jiao po
饥肠辘辘	ji chang lu lu
饭来张口	fan lai zhang kou
饮水思源	yin shui si yuan
饮食起居	yin shi qi ju
饮鸩止渴	yin zhen zhi ke
饮鸩解渴	yin zhen jie ke
饱学之士	bao xue zhi shi
饱经世故	bao jing shi gu
饱经忧患	bao jing you huan
饱经沧桑	bao jing cang sang
饱经风雨	bao jing feng yu
饱经风霜	bao jing feng shuang
饱食终日	bao shi zhong ri
饱餐一顿	bao can yi dun
饶有兴味	rao you xing wei
饶有兴趣	rao you xing qu
饶有风趣	rao you feng qu
饿虎扑羊	e hu pu yang
饿虎扑食	e hu pu shi
馋涎欲滴	chan xian yu di
首尾相连	shou wei xiang lian
首屈一指	shou qu yi zhi
首当其冲	shou dang qi chong
首战告捷	shou zhan gao jie
首鼠两端	shou shu liang duan
香火不断	xiang huo bu duan
马不停蹄	ma bu ting ti
马到功成	ma dao gong cheng
马到成功	ma dao cheng gong
马首是瞻	ma shou shi zhan
马马虎虎	ma ma hu hu
驰名中外	chi ming zhong wai
驰名天下	chi ming tian xia
驷马难追	si ma nan zhui
驾轻就熟	jia qing jiu shu
骁勇善战	xiao yong shan zhan
骂骂咧咧	ma ma lie lie
骄傲自大	jiao ao zi da
骄傲自满	jiao ao zi man
骄兵必败	jiao bing bi bai
骄奢淫逸	jiao she yin yi
骄横跋扈	jiao heng ba hu
骇人听闻	hai ren ting wen
骑虎难下	qi hu nan xia
骑马找马	qi ma zhao ma
骨瘦如柴	gu shou ru chai
骨肉之情	gu rou zhi qing
骨肉分离	gu rou fen li
骨肉相残	gu rou xiang can
骨肉相连	gu rou xiang lian
骨肉至亲	gu rou zhi qin
骨鲠在喉	gu geng zai hou
高不可攀	gao bu ke pan
高人一等	gao ren yi deng
高人一筹	gao ren yi chou
高低贵贱	gao di gui jian
高傲自大	gao ao zi da
高出一筹	gao chu yi chou
高官厚禄	gao guan hou lu
高屋建瓴	gao wu jian ling
高山峻岭	gao shan jun ling
高山流水	gao shan liu shui
高抬贵手	gao tai gui shou
高攀不上	gao pan bu shang
高朋满座	gao peng man zuo
高枕无忧	gao zhen wu you
高楼大厦	gao lou da sha
高歌猛进	gao ge meng jin
高深莫测	gao shen mo ce
高瞻远瞩	gao zhan yuan zhu
高耸入云	gao song ru yun
高视阔步	gao shi kuo bu
高谈阔论	gao tan kuo lun
高风亮节	gao feng liang jie
高高兴兴	gao gao xing xing
高高在上	gao gao zai shang
鬼使神差	gui shi shen chai
鬼哭狼嚎	gui ku lang hao
鬼头鬼脑	gui tou gui nao
鬼斧神工	gui fu shen gong
鬼蜮伎俩	gui yu ji liang
鬼话连篇	gui hua lian pian
鬼迷心窍	gui mi xin qiao
鬼鬼祟祟	gui gui sui sui
魂不守舍	hun bu shou she
魂不附体	hun bu fu ti
魂牵梦萦	hun qian meng ying
魂飞天外	hun fei tian wai
魂飞魄散	hun fei po san
魅力四射	mei li si she
鱼与熊掌	yu yu xiong zhang
鱼死网破	yu si wang po
鱼水情深	yu shui qing shen
鱼目混珠	yu mu hun zhu
鱼米之乡	yu mi zhi xiang
鱼肉百姓	yu rou bai xing
鱼贯而入	yu guan er ru
鱼贯而出	yu guan er chu
鱼贯而行	yu guan er xing
鱼跃龙门	yu yue long men
鱼龙混杂	yu long hun za
鲜为人知	xian wei ren zhi
鲜艳夺目	xian yan duo mu
鲜血淋漓	xian xue lin li
鲸吞蚕食	jing tun can shi
鳞次栉比	lin ci zhi bi
鸟尽弓藏	niao jin gong cang
鸟枪换炮	niao qiang huan pao
鸟语花香	niao yu hua xiang
鸠占鹊巢	jiu zhan que chao
鸡毛蒜皮	ji mao suan pi
鸡犬不宁	ji quan bu ning
鸡犬不留	ji quan bu liu
鸡犬升天	ji quan sheng tian
鸡犬相闻	ji quan xiang wen
鸡皮疙瘩	ji pi ge da
鸡零狗碎	ji ling gou sui
鸡飞狗跳	ji fei gou tiao
鸡飞蛋打	ji fei dan da
鸡鸣狗吠	ji ming gou fei
鸡鸣狗盗	ji ming gou dao
鸣冤叫屈	ming yuan jiao qu
鸣金收兵	ming jin shou bing
鸦雀无声	ya que wu sheng
鸿篇巨制	hong pian ju zhi
鸿篇巨著	hong pian ju zhu
鸿运当头	hong yun dang tou
鸿鹄之志	hong hu zhi zhi
鹅毛大雪	e mao da xue
鹊巢鸠占	que chao jiu zhan
鹊桥相会	que qiao xiang hui
鹏程万里	peng cheng wan li
鹤发童颜	he fa tong yan
鹤立鸡群	he li ji qun
鹦鹉学舌	ying wu xue she
鹦鹉学语	ying wu xue yu
鹬蚌相争	yu bang xiang zheng
鹬蚌相持	yu bang xiang chi
鹬蚌相斗	yu bang xiang dou
鹿死谁手	lu si shui shou
麻木不仁	ma mu bu ren
麻痹大意	ma bi da yi
黄粱一梦	huang liang yi meng
黄粱美梦	huang liang mei meng
黄袍加身	huang pao jia shen
黄道吉日	huang dao ji ri
黄金时代	huang jin shi dai
黄金时间	huang jin shi jian
黄雀在后	huang que zai hou
黎民百姓	li min bai xing
黑灯瞎火	hei deng xia huo
黑白不分	hei bai bu fen
黑白分明	hei bai fen ming
黔驴技穷	qian lu ji qiong
默不作声	mo bu zuo sheng
默不做声	mo bu zuo sheng
默默不语	mo mo bu yu
默默无声	mo mo wu sheng
默默无言	mo mo wu yan
默默无语	mo mo wu yu
默默无闻	mo mo wu wen
黯淡无光	an dan wu guang
黯然失色	an ran shi se
黯然神伤	an ran shen shang
鼎力相助	ding li xiang zhu
鼎足而立	ding zu er li
鼎鼎大名	ding ding da ming
鼎鼎有名	ding ding you ming
鼓乐喧天	gu yue xuan tian
鼓舞人心	gu wu ren xin
鼓足干劲	gu zu gan jin
鼠目寸光	shu mu cun guang
鼠肚鸡肠	shu du ji chang
鼻青眼肿	bi qing yan zhong
鼻青脸肿	bi qing lian zhong
鼾声如雷	han sheng ru lei
齐头并进	qi tou bing jin
齐心一致	qi xin yi zhi
齐心协力	qi xin xie li
齐心合力	qi xin he li
齐驱并进	qi qu bing jin
龇牙咧嘴	zi ya lie zui
龙争虎斗	long zheng hu dou
龙凤呈祥	long feng cheng xiang
龙潭虎穴	long tan hu xue
龙盘虎踞	long pan hu ju
龙腾虎跃	long teng hu yue
龙蛇混杂	long she hun za
龙蟠虎踞	long pan hu ju
龙行虎步	long xing hu bu
龙飞凤舞	long fei feng wu
龙马精神	long ma jing shen
